の	の
は	は
に	に
を	を
と	と
も	も
が	が
で	で
から	から
だ	だ
する	する
か	か
よ	よ
ある	ある
こと	こと
なる	なる
それ	それ
いる	いる
ね	ね
思う	おもう
この	この
には	には
でも	でも
です	です
その	その
な	な
言う	いう
って	って
ない	ない
んだ	んだ
そう	そう
私	わたし
いい	いい
これ	これ
だった	だった
見る	みる
だけ	だけ
くる	くる
さん	さん
くれる	くれる
やる	やる
まで	まで
もの	もの
行く	いく
という	という
もう	もう
だから	だから
そんな	そんな
あの	あの
だろう	だろう
no	data
しまう	しまう
来る	くる
ん	ん
人	ひと
ここ	ここ
や	や
し	し
お	お
とする	とする
自分	じぶん
じゃない	じゃない
知る	しる
なら	なら
いく	いく
わ	わ
今	いま
聞く	きく
へ	へ
ような	ような
とは	とは
何	なに
前	まえ
出る	でる
中	なか
にも	にも
ように	ように
顔	かお
である	である
んです	んです
また	また
ながら	ながら
なんて	なんて
考える	かんがえる
どう	どう
いう	いう
さ	さ
そして	そして
ため	ため
まだ	まだ
いや	いや
ちょっと	ちょっと
のに	のに
できる	できる
話	はなし
とか	とか
ぞ	ぞ
そこ	そこ
なの	なの
ではない	ではない
何	なん
待つ	まつ
ので	ので
ところ	ところ
だって	だって
だが	だが
たち	たち
こんな	こんな
持つ	もつ
みる	みる
声	こえ
もらう	もらう
入る	はいる
手	て
ですか	ですか
見える	みえる
方	ほう
目	め
男	おとこ
本当	ほんとう
あなた	あなた
今日	きょう
ほど	ほど
言葉	ことば
らしい	らしい
として	として
など	など
ただ	ただ
しかし	しかし
かな	かな
違う	ちがう
使う	つかう
少し	すこし
より	より
時	とき
家	いえ
あれ	あれ
彼	かれ
よい	よい
人間	にんげん
同じ	おなじ
上	うえ
よく	よく
よう	よう
とも	とも
でしょう	でしょう
出す	だす
どこ	どこ
しか	しか
悪い	わるい
なん	なん
時間	じかん
部屋	へや
わけ	わけ
おく	おく
かもしれない	かもしれない
作る	つくる
まま	まま
て	て
早い	はやい
感じる	かんじる
呼ぶ	よぶ
話す	はなす
何か	なにか
のように	のように
死ぬ	しぬ
姿	すがた
頭	あたま
強い	つよい
こう	こう
いつも	いつも
会う	あう
ばかり	ばかり
一緒に	いっしょに
好き	すき
相手	あいて
帰る	かえる
みんな	みんな
音	おと
うち	うち
ずっと	ずっと
のです	のです
でした	でした
食べる	たべる
場所	ばしょ
あと	あと
どうして	どうして
もっと	もっと
くらい	くらい
世界	せかい
あげる	あげる
戻る	もどる
力	ちから
仕事	しごと
必要	ひつよう
続ける	つづける
つもり	つもり
どんな	どんな
誰	だれ
による	による
次	つぎ
かける	かける
見せる	みせる
動く	うごく
となる	となる
はず	はず
子	こ
歩く	あるく
こちら	こちら
きっと	きっと
意味	いみ
終わる	おわる
変わる	かわる
すぐに	すぐに
とき	とき
気持ち	きもち
始める	はじめる
大きい	おおきい
ことになる	ことになる
向かう	むかう
何も	なにも
受ける	うける
日	ひ
年	ねん
心配	しんぱい
教える	おしえる
心	こころ
立つ	たつ
おる	おる
やめる	やめる
外	そと
間	あいだ
について	について
よりも	よりも
後	あと
様子	ようす
忘れる	わすれる
口	くち
にとって	にとって
名前	なまえ
大きな	おおきな
信じる	しんじる
すぎる	すぎる
なのに	なのに
生きる	いきる
問題	もんだい
理由	りゆう
それでも	それでも
これから	これから
以上	いじょう
逃げる	にげる
多い	おおい
そういう	そういう
絶対	ぜったい
開く	ひらく
今度	こんど
最後	さいご
最初	さいしょ
こそ	こそ
存在	そんざい
誰か	だれか
初めて	はじめて
書く	かく
取る	とる
高い	たかい
もちろん	もちろん
かも	かも
べき	べき
入れる	いれる
体	からだ
答える	こたえる
そのまま	そのまま
置く	おく
覚える	おぼえる
あり	あり
無理	むり
ご	ご
残る	のこる
いけない	いけない
長い	ながい
普通	ふつう
どういう	どういう
守る	まもる
とても	とても
楽しい	たのしい
どこか	どこか
夜	よる
感じ	かんじ
気	き
許す	ゆるす
もし	もし
驚く	おどろく
別に	べつに
離れる	はなれる
いつ	いつ
消える	きえる
助ける	たすける
止める	とめる
困る	こまる
かかる	かかる
no	data
人	にん
中	ちゅう
方	かた
飲む	のむ
走る	はしる
以外	いがい
下	した
買う	かう
足	あし
説明	せつめい
読む	よむ
女性	じょせい
落ちる	おちる
このまま	このまま
つける	つける
起きる	おきる
あまり	あまり
ことができる	ことができる
続く	つづく
すぐ	すぐ
決める	きめる
でもない	でもない
状況	じょうきょう
関係	かんけい
ことがある	ことがある
いただく	いただく
先	さき
伝える	つたえる
ようになる	ようになる
先に	さきに
夢	ゆめ
誰も	だれも
小さい	ちいさい
選ぶ	えらぶ
こういう	こういう
理解	りかい
ですが	ですが
場合	ばあい
得る	える
深い	ふかい
見つける	みつける
一度	いちど
ほしい	ほしい
なぜ	なぜ
昔	むかし
水	みず
近く	ちかく
進む	すすむ
大変	たいへん
としても	としても
道	みち
簡単	かんたん
変える	かえる
別	べつ
なので	なので
本	ほん
完全	かんぜん
状態	じょうたい
しっかり	しっかり
行う	おこなう
送る	おくる
形	かたち
上げる	あげる
近づく	ちかづく
乗る	のる
与える	あたえる
勝手	かって
的	てき
結果	けっか
ために	ために
朝	あさ
新しい	あたらしい
急	きゅう
ようにする	ようにする
自分で	じぶんで
元	もと
最近	さいきん
大	だい
決まる	きまる
準備	じゅんび
近い	ちかい
失う	うしなう
不安	ふあん
残す	のこす
安心	あんしん
大事	だいじ
ほとんど	ほとんど
認める	みとめる
特に	とくに
求める	もとめる
用意	ようい
少ない	すくない
まず	まず
ことにする	ことにする
始まる	はじまる
家族	かぞく
似る	にる
用	よう
元気	げんき
後	ご
に対して	にたいして
生む	うむ
思い	おもい
なかなか	なかなか
たくさん	たくさん
目的	もくてき
合う	あう
生活	せいかつ
方法	ほうほう
なくなる	なくなる
切る	きる
分	ぶん
つく	つく
としては	としては
十分	じゅうぶん
働く	はたらく
若い	わかい
歳	さい
調べる	しらべる
急ぐ	いそぐ
必ず	かならず
かどうか	かどうか
途中	とちゅう
側	がわ
見つかる	みつかる
重い	おもい
期待	きたい
集まる	あつまる
その後	そのあと
とる	とる
ないと	ないと
考え	かんがえ
住む	すむ
大切	たいせつ
毎日	まいにち
広い	ひろい
やすい	やすい
自由	じゆう
になると	になると
ないか	ないか
原因	げんいん
けど	けど
俺	おれ
ああ	ああ
はい	はい
じゃ	じゃ
うん	うん
お前	おまえ
彼女	かのじょ
みたい	みたい
大丈夫	だいじょうぶ
ちゃん	ちゃん
よね	よね
わかる	わかる
え	え
あっ	あっ
僕	ぼく
なんか	なんか
ください	ください
笑う	わらう
なんだ	なんだ
no	data
じゃあ	じゃあ
分かる	わかる
様	さま
まあ	まあ
だろ	だろ
ええ	ええ
女	おんな
君	きみ
君	くん
だけど	だけど
二人	ふたり
者	もの
やっぱり	やっぱり
でしょ	でしょ
えっ	えっ
ちゃんと	ちゃんと
こっち	こっち
すごい	すごい
確かに	たしかに
聞こえる	きこえる
なんで	なんで
先生	せんせい
だろうか	だろうか
まさか	まさか
ようだ	ようだ
ねえ	ねえ
そうだ	そうだ
なんです	なんです
けれど	けれど
なに	なに
まるで	まるで
他	ほか
殺す	ころす
事	こと
じゃないか	じゃないか
胸	むね
さっき	さっき
no	data
思い出す	おもいだす
へと	へと
あんた	あんた
おい	おい
一番	いちばん
一人	ひとり
ありがとう	ありがとう
そうか	そうか
頼む	たのむ
一つ	ひとつ
表情	ひょうじょう
ごめん	ごめん
怖い	こわい
良い	よい
ゆっくり	ゆっくり
つまり	つまり
だったら	だったら
腕	うで
それから	それから
ほら	ほら
あ	あ
欲しい	ほしい
やはり	やはり
確認	かくにん
そうです	そうです
全部	ぜんぶ
何度	なんど
そんなに	そんなに
ほう	ほう
子供	こども
二	に
光	ひかり
おかしい	おかしい
寝る	ねる
なのだ	なのだ
なるほど	なるほど
もん	もん
小さな	ちいさな
瞬間	しゅんかん
気がする	きがする
今まで	いままで
優しい	やさしい
嫌	いや
あいつ	あいつ
ううん	ううん
明日	あした
泣く	なく
頑張る	がんばる
怒る	おこる
はずだ	はずだ
あんな	あんな
娘	むすめ
今回	こんかい
やつ	やつ
昨日	きのう
ですから	ですから
かしら	かしら
変	へん
探す	さがす
しかも	しかも
返す	かえす
国	くに
なあ	なあ
当然	とうぜん
座る	すわる
でしょうか	でしょうか
つつ	つつ
ではある	ではある
黙る	だまる
気づく	きづく
しばらく	しばらく
いえ	いえ
隠す	かくす
気になる	きになる
奥	おく
向ける	むける
笑顔	えがお
かなり	かなり
軽い	かるい
目の前	めのまえ
お願い	おねがい
開ける	あける
せい	せい
まったく	まったく
女の子	おんなのこ
こんなに	こんなに
しかない	しかない
ならば	ならば
とにかく	とにかく
ことはない	ことはない
痛い	いたい
敵	てき
一	いち
実は	じつは
後ろ	うしろ
そこまで	そこまで
物	もの
さらに	さらに
髪	かみ
no	data
一瞬	いっしゅん
落ち着く	おちつく
どうした	どうした
隣	となり
不思議	ふしぎ
戦う	たたかう
さあ	さあ
こいつ	こいつ
現れる	あらわれる
そろそろ	そろそろ
私たち	わたしたち
記憶	きおく
彼ら	かれら
すべて	すべて
学校	がっこう
さえ	さえ
情報	じょうほう
意識	いしき
というのは	というのは
肩	かた
色	いろ
触れる	ふれる
勝つ	かつ
結局	けっきょく
三	さん
全然	ぜんぜん
上がる	あがる
げ	げ
動き	うごき
白い	しろい
指	ゆび
可能性	かのうせい
赤い	あかい
失礼	しつれい
幸せ	しあわせ
負ける	まける
背中	せなか
反応	はんのう
壁	かべ
どうやら	どうやら
いきなり	いきなり
空	そら
約束	やくそく
血	ち
服	ふく
恥ずかしい	はずかしい
過ぎる	すぎる
事実	じじつ
静か	しずか
すむ	すむ
行動	こうどう
突然	とつぜん
友達	ともだち
喜ぶ	よろこぶ
止まる	とまる
命	いのち
自身	じしん
想像	そうぞう
面白い	おもしろい
父	ちち
身	み
渡す	わたす
名	な
ようやく	ようやく
全員	ぜんいん
頃	ころ
そもそも	そもそも
空気	くうき
再び	ふたたび
着る	きる
母	はは
首	くび
美しい	うつくしい
一体	いったい
店	みせ
程度	ていど
届く	とどく
さて	さて
難しい	むずかしい
向こう	むこう
神	かみ
気分	きぶん
耳	みみ
ごめんなさい	ごめんなさい
通り	とおり
ひどい	ひどい
むしろ	むしろ
飛ぶ	とぶ
眠る	ねむる
仲間	なかま
でない	でない
さすがに	さすがに
山	やま
感情	かんじょう
ぐらい	ぐらい
結構	けっこう
すら	すら
危険	きけん
以前	いぜん
no	data
no	data
もう一度	もういちど
ありがとうございます	ありがとうございます
どうぞ	どうぞ
済む	すむ
とりあえず	とりあえず
任せる	まかせる
遅い	おそい
気にする	きにする
いくら	いくら
本気	ほんき
あら	あら
正直	しょうじき
動かす	うごかす
事件	じけん
きる	きる
そういえば	そういえば
おりる	おりる
起こす	おこす
周囲	しゅうい
海	うみ
すでに	すでに
叫ぶ	さけぶ
引く	ひく
返事	へんじ
逆	ぎゃく
捨てる	すてる
甘い	あまい
窓	まど
遊ぶ	あそぶ
結婚	けっこん
おお	おお
会話	かいわ
戻ってくる	もどってくる
どうしたの	どうしたの
邪魔	じゃま
腰	こし
その時	そのとき
うまい	うまい
握る	にぎる
確か	たしか
いっぱい	いっぱい
部分	ぶぶん
無事	ぶじ
せっかく	せっかく
風	かぜ
起こる	おこる
であろう	であろう
熱い	あつい
意外	いがい
これ以上	これいじょう
間違いない	まちがいない
流れる	ながれる
花	はな
涙	なみだ
やってくる	やってくる
倒れる	たおれる
人生	じんせい
一人で	ひとりで
もう少し	もうすこし
襲う	おそう
所	ところ
料理	りょうり
決して	けっして
愛する	あいする
黒い	くろい
冷たい	つめたい
合わせる	あわせる
楽しむ	たのしむ
自然	しぜん
納得	なっとく
周り	まわり
どうも	どうも
珍しい	めずらしい
いいから	いいから
どうしても	どうしても
疲れる	つかれる
必死	ひっし
前に	まえに
内	ない
追う	おう
激しい	はげしい
場	ば
食う	くう
慣れる	なれる
勢い	いきおい
答え	こたえ
落とす	おとす
同時に	どうじに
判断	はんだん
横	よこ
町	まち
報告	ほうこく
食事	しょくじ
緊張	きんちょう
金	かね
受け取る	うけとる
まずは	まずは
感謝	かんしゃ
no	data
者	しゃ
日本	にほん
つい	つい
並ぶ	ならぶ
避ける	さける
連絡	れんらく
奪う	うばう
過ごす	すごす
狙う	ねらう
向く	むく
諦める	あきらめる
足りる	たりる
いろいろ	いろいろ
そうする	そうする
話をする	はなしをする
望む	のぞむ
一応	いちおう
特別	とくべつ
救う	すくう
帰ってくる	かえってくる
時代	じだい
いらっしゃる	いらっしゃる
いつか	いつか
終わり	おわり
語る	かたる
繰り返す	くりかえす
助かる	たすかる
点	てん
ところで	ところで
運ぶ	はこぶ
素直	すなお
よし	よし
態度	たいど
失敗	しっぱい
とこ	とこ
全く	まったく
木	き
それぞれ	それぞれ
内容	ないよう
と言われる	といわれる
示す	しめす
妙	みょう
あんまり	あんまり
冗談	じょうだん
自ら	みずから
低い	ひくい
わざわざ	わざわざ
そっち	そっち
雰囲気	ふんいき
はっきり	はっきり
移動	いどう
過去	かこ
手伝う	てつだう
描く	えがく
余裕	よゆう
なんとか	なんとか
出会う	であう
と言う	という
みせる	みせる
やっと	やっと
嫌い	きらい
質問	しつもん
人々	ひとびと
どれ	どれ
現実	げんじつ
感覚	かんかく
正しい	ただしい
未来	みらい
興味	きょうみ
遠い	とおい
ながらも	ながらも
本人	ほんにん
能力	のうりょく
あの人	あのひと
っぽい	っぽい
それでは	それでは
と言った	といった
その場	そのば
事情	じじょう
暗い	くらい
あそこ	あそこ
んで	んで
休む	やすむ
一緒	いっしょ
おかげで	おかげで
なさる	なさる
息	いき
これまで	これまで
予定	よてい
伝わる	つたわる
距離	きょり
どうせ	どうせ
多く	おおく
残念	ざんねん
ま	ま
終える	おえる
覚悟	かくご
勉強	べんきょう
さすが	さすが
上	じょう
分	ふん
風	ふう
no	data
だけに	だけに
自信	じしん
我慢	がまん
相談	そうだん
死	し
増える	ふえる
離す	はなす
半分	はんぶん
人物	じんぶつ
回る	まわる
親	おや
弱い	よわい
っけ	っけ
立てる	たてる
この人	このひと
といった	といった
降りる	おりる
打つ	うつ
席	せき
経験	けいけん
よろしく	よろしく
すっかり	すっかり
現在	げんざい
広がる	ひろがる
に対する	にたいする
振る	ふる
集める	あつめる
当たる	あたる
直接	ちょくせつ
数	かず
明るい	あかるい
ということは	ということは
件	けん
当たり前	あたりまえ
お金	おかね
抱える	かかえる
連れる	つれる
他人	たにん
母親	ははおや
忙しい	いそがしい
寂しい	さびしい
くださる	くださる
どうか	どうか
誘う	さそう
いたす	いたす
立場	たちば
そのため	そのため
他に	ほかに
大好き	だいすき
協力	きょうりょく
抜ける	ぬける
持ってくる	もってくる
のみ	のみ
詳しい	くわしい
押す	おす
愛	あい
だす	だす
もつ	もつ
変化	へんか
男性	だんせい
ような気がする	ようなきがする
車	くるま
断る	ことわる
利用	りよう
熱	ねつ
というもの	というもの
抱く	いだく
苦しい	くるしい
最高	さいこう
満足	まんぞく
無視	むし
余計	よけい
一気に	いっきに
どちら	どちら
成功	せいこう
限り	かぎり
代わりに	かわりに
ではないか	ではないか
父親	ちちおや
通る	とおる
暮らす	くらす
わけではない	わけではない
雨	あめ
写真	しゃしん
火	ひ
否定	ひてい
借りる	かりる
面倒	めんどう
人たち	ひとたち
厳しい	きびしい
危ない	あぶない
どっち	どっち
どうやって	どうやって
ときに	ときに
今から	いまから
参加	さんか
no	data
no	data
隠れる	かくれる
裏	うら
短い	みじかい
ちょうど	ちょうど
機会	きかい
恐ろしい	おそろしい
大人	おとな
売る	うる
輝く	かがやく
すぎ	すぎ
耐える	たえる
悲しい	かなしい
たとえ	たとえ
受け入れる	うけいれる
どうしよう	どうしよう
味	あじ
迷う	まよう
手に入れる	てにいれる
どんどん	どんどん
関係ない	かんけいない
秘密	ひみつ
部	ぶ
例	れい
いずれ	いずれ
それにしても	それにしても
包む	つつむ
川	かわ
着く	つく
明らか	あきらか
そのもの	そのもの
地	ち
える	える
願う	ねがう
位置	いち
方向	ほうこう
戻す	もどす
一部	いちぶ
客	きゃく
薄い	うすい
よろしい	よろしい
調子	ちょうし
迎える	むかえる
流す	ながす
新た	あらた
平気	へいき
外す	はずす
かもしれません	かもしれません
改めて	あらためて
どれだけ	どれだけ
進める	すすめる
において	において
うるさい	うるさい
去る	さる
腹	はら
それ以上	それいじょう
くせに	くせに
たまに	たまに
と思われる	とおもわれる
間違う	まちがう
実際	じっさい
皆さん	みなさん
悩む	なやむ
迫る	せまる
まだまだ	まだまだ
第一	だいいち
友人	ゆうじん
練習	れんしゅう
と同時に	とどうじに
まさに	まさに
疑う	うたがう
目指す	めざす
右	みぎ
消す	けす
気に入る	きにいる
払う	はらう
性格	せいかく
それまで	それまで
かつて	かつて
遠く	とおく
今後	こんご
発見	はっけん
ことがない	ことがない
同じよう	おなじよう
希望	きぼう
ついに	ついに
集中	しゅうちゅう
万	まん
効果	こうか
意見	いけん
何より	なにより
そのこと	そのこと
息子	むすこ
訪れる	おとずれる
であれば	であれば
証拠	しょうこ
一日	いちにち
月	つき
遠慮	えんりょ
時	じ
名	めい
数	すう
実際に	じっさいに
暇	ひま
影響	えいきょう
相当	そうとう
なし	なし
のせいで	のせいで
建物	たてもの
ほぼ	ほぼ
重要	じゅうよう
せめて	せめて
後悔	こうかい
誰にも	だれにも
いなくなる	いなくなる
紹介	しょうかい
疑問	ぎもん
速い	はやい
抜く	ぬく
楽	らく
予想	よそう
超える	こえる
努力	どりょく
円	えん
立派	りっぱ
一方	いっぽう
確実	かくじつ
当時	とうじ
妻	つま
通う	かよう
流れ	ながれ
責任	せきにん
偶然	ぐうぜん
作業	さぎょう
運命	うんめい
どの	どの
伸びる	のびる
下がる	さがる
気をつける	きをつける
可能	かのう
支える	ささえる
非常	ひじょう
一歩	いっぽ
最も	もっとも
確かめる	たしかめる
乗せる	のせる
お話	おはなし
常に	つねに
通じる	つうじる
得意	とくい
二度と	にどと
関わる	かかわる
あんなに	あんなに
成長	せいちょう
遅れる	おくれる
本来	ほんらい
きり	きり
注意	ちゅうい
夏	なつ
取れる	とれる
計画	けいかく
直す	なおす
問う	とう
役	やく
その日	そのひ
にしても	にしても
解決	かいけつ
扱う	あつかう
重ねる	かさねる
ものがある	ものがある
混乱	こんらん
案内	あんない
寒い	さむい
罪	つみ
事態	じたい
行為	こうい
とともに	とともに
に向けて	にむけて
いつまでも	いつまでも
中心	ちゅうしん
条件	じょうけん
屋	や
左	ひだり
型	かた
展開	てんかい
残り	のこり
量	りょう
その中	そのなか
一切	いっさい
迷惑	めいわく
古い	ふるい
結ぶ	むすぶ
別れる	わかれる
というより	というより
抑える	おさえる
といい	といい
番	ばん
楽しみ	たのしみ
日々	ひび
年	とし
間	かん
気	げ
下	もと
間違い	まちがい
なお	なお
その人	そのひと
頼る	たよる
目立つ	めだつ
苦労	くろう
ごと	ごと
信用	しんよう
唯一	ゆいいつ
寄る	よる
減る	へる
間に合う	まにあう
到着	とうちゃく
面	めん
差	さ
時には	ときには
価値	かち
対応	たいおう
額	がく
含む	ふくむ
まとめる	まとめる
すべき	すべき
有名	ゆうめい
反対	はんたい
安全	あんぜん
でる	でる
ついてる	ついてる
ぶり	ぶり
午後	ごご
切れる	きれる
活動	かつどう
時期	じき
際	さい
正確	せいかく
以来	いらい
大きくなる	おおきくなる
完成	かんせい
なり	なり
貸す	かす
新	しん
たった	たった
降る	ふる
最後まで	さいごまで
狭い	せまい
出かける	でかける
至る	いたる
でもある	でもある
一生	いっしょう
信頼	しんらい
不満	ふまん
といえば	といえば
全体	ぜんたい
よる	よる
病気	びょうき
複雑	ふくざつ
代	だい
含める	ふくめる
違い	ちがい
ほか	ほか
育てる	そだてる
ままに	ままに
少しでも	すこしでも
にくい	にくい
保つ	たもつ
回	かい
通す	とおす
役に立つ	やくにたつ
学ぶ	まなぶ
このよう	このよう
比べる	くらべる
限る	かぎる
対象	たいしょう
度	ど
そのうち	そのうち
世の中	よのなか
加える	くわえる
亡くなる	なくなる
最大	さいだい
人気	にんき
及ぶ	およぶ
将来	しょうらい
種類	しゅるい
半	はん
苦しむ	くるしむ
訴える	うったえる
ずつ	ずつ
たつ	たつ
関する	かんする
決定	けってい
なくす	なくす
分ける	わける
いわゆる	いわゆる
にかけて	にかけて
よな	よな
視線	しせん
嬉しい	うれしい
no	data
出来る	できる
ダメ	ダメ
見つめる	みつめる
全て	すべて
少女	しょうじょ
扉	とびら
わたし	わたし
もしかして	もしかして
俺たち	おれたち
瞳	ひとみ
先輩	せんぱい
皆	みんな
奴	やつ
はあ	はあ
五	ご
慌てる	あわてる
街	まち
達	たち
というか	というか
なんだか	なんだか
攻撃	こうげき
なぁ	なぁ
妹	いもうと
じゃん	じゃん
立ち上がる	たちあがる
唇	くちびる
はっ	はっ
ねぇ	ねぇ
震える	ふるえる
浮かべる	うかべる
可愛い	かわいい
気付く	きづく
あー	あー
両手	りょうて
んん	んん
身体	からだ
すみません	すみません
三人	さんにん
お母さん	おかあさん
眺める	ながめる
何だ	なんだ
ドア	ドア
床	ゆか
かい	かい
やがる	やがる
ベッド	ベッド
少年	しょうねん
そりゃ	そりゃ
森	もり
わけじゃない	わけじゃない
ひとつ	ひとつ
倒す	たおす
構う	かまう
響く	ひびく
あの子	あのこ
笑み	えみ
謝る	あやまる
振り返る	ふりかえる
かよ	かよ
仕方ない	しかたない
やがて	やがて
我々	われわれ
口にする	くちにする
バカ	バカ
ふと	ふと
肉	にく
まい	まい
地面	じめん
えっと	えっと
何で	なんで
お父さん	おとうさん
叩く	たたく
そっか	そっか
見上げる	みあげる
声をかける	こえをかける
全身	ぜんしん
連中	れんちゅう
さま	さま
戦い	たたかい
告げる	つげる
気配	けはい
と共に	とともに
そっと	そっと
廊下	ろうか
取り出す	とりだす
影	かげ
色々	いろいろ
噂	うわさ
四	よん
兄	あに
怒り	いかり
嘘	うそ
生徒	せいと
相変わらず	あいかわらず
浮かぶ	うかぶ
そうですね	そうですね
傷	きず
痛み	いたみ
放つ	はなつ
体	たい
なのです	なのです
背後	はいご
闇	やみ
おう	おう
普段	ふだん
綺麗	きれい
手紙	てがみ
下さる	くださる
かのように	かのように
電話	でんわ
じっと	じっと
お願いします	おねがいします
だからこそ	だからこそ
挨拶	あいさつ
テーブル	テーブル
かね	かね
無駄	むだ
かわいい	かわいい
王	おう
さっさ	さっさ
２人	ふたり
村	むら
触る	さわる
六	ろく
駄目	だめ
巨大	きょだい
光景	こうけい
多分	たぶん
黒	くろ
ござる	ござる
石	いし
だよね	だよね
おそらく	おそらく
二つ	ふたつ
付き合う	つきあう
肌	はだ
武器	ぶき
当てる	あてる
椅子	いす
そいつ	そいつ
無い	ない
恐怖	きょうふ
おいしい	おいしい
命令	めいれい
本当に	ほんとうに
たぶん	たぶん
いったい	いったい
す	す
マジ	マジ
口を開く	くちをひらく
匂い	におい
格好	かっこう
そうね	そうね
頬	ほお
っていう	っていう
クラス	クラス
いやいや	いやいや
それじゃ	それじゃ
尋ねる	たずねる
うわ	うわ
犬	いぬ
もはや	もはや
階段	かいだん
そう言う	そういう
いいえ	いいえ
もしかしたら	もしかしたら
机	つくえ
先ほど	さきほど
ゲーム	ゲーム
勝負	しょうぶ
そうそう	そうそう
本物	ほんもの
だめ	だめ
レベル	レベル
真剣	しんけん
七	なな
星	ほし
まずい	まずい
教室	きょうしつ
いま	いま
そのとき	そのとき
鋭い	するどい
あたり	あたり
口調	くちょう
姉	あね
似合う	にあう
方がいい	ほうがいい
ちなみに	ちなみに
揺れる	ゆれる
話しかける	はなしかける
あるいは	あるいは
視界	しかい
そうだね	そうだね
限界	げんかい
作戦	さくせん
頭を下げる	あたまをさげる
申す	もうす
お互い	おたがい
なんじゃ	なんじゃ
no	data
家	け
既に	すでに
取り戻す	とりもどす
右手	みぎて
女子	じょし
ばっかり	ばっかり
白	しろ
猫	ねこ
馬鹿	ばか
適当	てきとう
そば	そば
なんでも	なんでも
一言	ひとこと
心臓	しんぞう
なぜか	なぜか
酒	さけ
いいか	いいか
違いない	ちがいない
魂	たましい
空間	くうかん
真面目	まじめ
たる	たる
お礼	おれい
薬	くすり
お茶	おちゃ
味方	みかた
炎	ほのお
タイミング	タイミング
両親	りょうしん
様に	ように
荷物	にもつ
それら	それら
細い	ほそい
警戒	けいかい
鍵	かぎ
飛び出す	とびだす
膝	ひざ
ほどに	ほどに
何とか	なんとか
というのに	というのに
興奮	こうふん
褒める	ほめる
我が	わが
指示	しじ
弟	おとうと
っていうか	っていうか
わずか	わずか
十	じゅう
舌	した
鳴る	なる
穴	あな
そちら	そちら
タイプ	タイプ
随分	ずいぶん
差し出す	さしだす
やら	やら
八	はち
ども	ども
閉じる	とじる
光る	ひかる
勘違い	かんちがい
警察	けいさつ
何でも	なんでも
伸ばす	のばす
それに	それに
冷静	れいせい
第	だい
頂く	いただく
怪しい	あやしい
馬	うま
衝撃	しょうげき
城	しろ
巻き込む	まきこむ
多少	たしょう
同士	どうし
って言う	っていう
そのよう	そのよう
恋人	こいびと
てる	てる
気がつく	きがつく
病院	びょういん
回す	まわす
わけない	わけない
汗	あせ
開始	かいし
それで	それで
まとも	まとも
青い	あおい
押さえる	おさえる
超	ちょう
ずいぶん	ずいぶん
提案	ていあん
悔しい	くやしい
一本	いっぽん
室	しつ
ってのは	ってのは
ど	ど
真実	しんじつ
研究	けんきゅう
人	じん
no	data
身体	しんたい
背	せ
いつの間にか	いつのまにか
我	われ
扱い	あつかい
回復	かいふく
どうでもいい	どうでもいい
知識	ちしき
恋	こい
抵抗	ていこう
ぜ	ぜ
犯人	はんにん
うれしい	うれしい
天	てん
広げる	ひろげる
に関して	にかんして
付く	つく
文字	もじ
苦手	にがて
引っ張る	ひっぱる
解放	かいほう
ともかく	ともかく
箱	はこ
追いかける	おいかける
真っ赤	まっか
見事	みごと
ほんと	ほんと
絵	え
でございます	でございます
あああ	あああ
おはよう	おはよう
嫌う	きらう
破壊	はかい
壊れる	こわれる
拾う	ひろう
今夜	こんや
囲む	かこむ
知り合い	しりあい
単純	たんじゅん
船	ふね
中身	なかみ
系	けい
とんでもない	とんでもない
なりに	なりに
辺り	あたり
完璧	かんぺき
脱ぐ	ぬぐ
全力	ぜんりょく
無言	むごん
へえ	へえ
門	もん
仲良く	なかよく
技術	ぎじゅつ
それじゃあ	それじゃあ
殴る	なぐる
大量	たいりょう
沈黙	ちんもく
感触	かんしょく
思考	しこう
どころか	どころか
試す	ためす
島	しま
ということだ	ということだ
言い方	いいかた
会社	かいしゃ
経つ	たつ
やっぱ	やっぱ
趣味	しゅみ
張る	はる
主	ぬし
紙	かみ
隙	すき
何者	なにもの
ふん	ふん
いよいよ	いよいよ
従う	したがう
異常	いじょう
中央	ちゅうおう
久しぶり	ひさしぶり
正体	しょうたい
長	ちょう
戦争	せんそう
穏やか	おだやか
なんとなく	なんとなく
左右	さゆう
吸う	すう
柔らかい	やわらかい
構える	かまえる
ただし	ただし
赤	あか
授業	じゅぎょう
ゆく	ゆく
式	しき
何もない	なにもない
そんなもの	そんなもの
しれる	しれる
不可能	ふかのう
投げる	なげる
no	data
no	data
洗う	あらう
見守る	みまもる
焼く	やく
天井	てんじょう
鳥	とり
思いつく	おもいつく
あっさり	あっさり
男の子	おとこのこ
雪	ゆき
ふざける	ふざける
確信	かくしん
イメージ	イメージ
わけにはいかない	わけにはいかない
この世	このよ
悲鳴	ひめい
辛い	つらい
こ	こ
話題	わだい
認識	にんしき
振り向く	ふりむく
あまりにも	あまりにも
申し訳ない	もうしわけない
わあ	わあ
化する	かする
焦る	あせる
問題ない	もんだいない
突っ込む	つっこむ
制服	せいふく
やってみる	やってみる
もうすぐ	もうすぐ
驚き	おどろき
許可	きょか
映る	うつる
壊す	こわす
きちんと	きちんと
あっち	あっち
裏切る	うらぎる
人形	にんぎょう
鼻	はな
謎	なぞ
その間	そのあいだ
二十	はたち
了解	りょうかい
発言	はつげん
その手	そのて
大した	たいした
組む	くむ
手段	しゅだん
最悪	さいあく
呼び出す	よびだす
ありがたい	ありがたい
誤解	ごかい
メートル	メートル
訳	わけ
吐く	はく
告白	こくはく
喉	のど
転がる	ころがる
旅	たび
見た目	みため
バレる	バレる
濡れる	ぬれる
呼吸	こきゅう
素晴らしい	すばらしい
出来事	できごと
行ってくる	いってくる
同様	どうよう
受け止める	うけとめる
少しずつ	すこしずつ
実に	じつに
自覚	じかく
きれい	きれい
見送る	みおくる
参る	まいる
爆発	ばくはつ
動揺	どうよう
着替える	きがえる
解く	とく
連れてくる	つれてくる
増す	ます
自体	じたい
東	ひがし
ぼんやり	ぼんやり
どうにか	どうにか
となると	となると
とはいえ	とはいえ
精神	せいしん
さっきから	さっきから
飛ばす	とばす
文句	もんく
踏む	ふむ
時点	じてん
発生	はっせい
あとで	あとで
付ける	つける
つかむ	つかむ
沈む	しずむ
と同じように	とおなじように
内	うち
抱く	だく
傷つける	きずつける
掃除	そうじ
ころ	ころ
二人とも	ふたりとも
はじめる	はじめる
道具	どうぐ
現場	げんば
春	はる
歴史	れきし
依頼	いらい
足音	あしおと
術	じゅつ
全	ぜん
たまる	たまる
手にする	てにする
一枚	いちまい
チャンス	チャンス
第二	だいに
ついでに	ついでに
思い出	おもいで
歌	うた
覆う	おおう
庭	にわ
ただいま	ただいま
応える	こたえる
だい	だい
ありがとうございました	ありがとうございました
恐れる	おそれる
毒	どく
騒ぐ	さわぐ
背負う	せおう
あまりに	あまりに
大学	だいがく
みな	みな
底	そこ
ぶつかる	ぶつかる
素敵	すてき
少々	しょうしょう
がな	がな
微妙	びみょう
担当	たんとう
お店	おみせ
怪我	けが
ひとり	ひとり
同じく	おなじく
例えば	たとえば
ほうがいい	ほうがいい
三十	さんじゅう
直後	ちょくご
調査	ちょうさ
今年	ことし
応援	おうえん
使用	しよう
言いながら	いいながら
早速	さっそく
玄関	げんかん
満ちる	みちる
予感	よかん
心の中	こころのなか
片手	かたて
逃げ出す	にげだす
速度	そくど
飛び込む	とびこむ
探る	さぐる
こら	こら
刺激	しげき
物語	ものがたり
男子	だんし
ありがと	ありがと
もしも	もしも
いいや	いいや
硬い	かたい
かあ	かあ
ひと	ひと
印象	いんしょう
感	かん
願い	ねがい
いくつか	いくつか
にしては	にしては
夫	おっと
意志	いし
あくまで	あくまで
魚	さかな
もともと	もともと
勝利	しょうり
意思	いし
もっとも	もっとも
こうする	こうする
察する	さっする
太陽	たいよう
ますます	ますます
歌う	うたう
大体	だいたい
才能	さいのう
と思ったら	とおもったら
はずがない	はずがない
果たす	はたす
選択	せんたく
並べる	ならべる
とっても	とっても
なか	なか
名乗る	なのる
東京	とうきょう
味わう	あじわう
燃える	もえる
自分でも	じぶんでも
真似	まね
越える	こえる
左手	ひだりて
懐かしい	なつかしい
パン	パン
入り口	いりぐち
部下	ぶか
間に	あいだに
鬼	おに
幼い	おさない
間違える	まちがえる
一度も	いちども
組	くみ
ほんの	ほんの
下げる	さげる
偉い	えらい
捕まえる	つかまえる
漂う	ただよう
鏡	かがみ
笑い	わらい
香り	かおり
この前	このまえ
優秀	ゆうしゅう
込める	こめる
発する	はっする
機	き
はずです	はずです
会	かい
あいつら	あいつら
たっぷり	たっぷり
わざと	わざと
崩れる	くずれる
いいこと	いいこと
証明	しょうめい
支配	しはい
潰す	つぶす
様々	さまざま
感心	かんしん
姿勢	しせい
先日	せんじつ
今すぐ	いますぐ
土地	とち
神様	かみさま
あらゆる	あらゆる
いろんな	いろんな
地下	ちか
承知	しょうち
に置いて	において
挟む	はさむ
年齢	ねんれい
とおり	とおり
西	にし
事故	じこ
やって来る	やってくる
訓練	くんれん
学生	がくせい
用事	ようじ
一年	いちねん
捜す	さがす
組織	そしき
地上	ちじょう
責める	せめる
わけがない	わけがない
なす	なす
固い	かたい
おいおい	おいおい
すっごい	すっごい
防ぐ	ふせぐ
祈る	いのる
整える	ととのえる
帰り	かえり
温かい	あたたかい
把握	はあく
覗く	のぞく
九	きゅう
込む	こむ
笑い声	わらいごえ
音がする	おとがする
効く	きく
冬	ふゆ
ように言う	ようにいう
漏れる	もれる
勇気	ゆうき
預ける	あずける
仕方がない	しかたがない
表現	ひょうげん
テレビ	テレビ
揃う	そろう
記録	きろく
育つ	そだつ
まくる	まくる
好きになる	すきになる
no	data
金	きん
no	data
宣言	せんげん
体力	たいりょく
絶望	ぜつぼう
まっすぐ	まっすぐ
よろしくお願いします	よろしくおねがいします
もうちょっと	もうちょっと
ご飯	ごはん
秒	びょう
空く	あく
吹く	ふく
強引	ごういん
百	ひゃく
平和	へいわ
甘える	あまえる
だけでなく	だけでなく
数日	すうじつ
骨	ほね
だの	だの
情けない	なさけない
決意	けつい
知れる	しれる
言い訳	いいわけ
下りる	おりる
観察	かんさつ
きつい	きつい
袋	ふくろ
違和感	いわかん
おっしゃる	おっしゃる
その通り	そのとおり
氷	こおり
つらい	つらい
北	きた
出て行く	でていく
寄せる	よせる
しょうがない	しょうがない
端	はし
メンバー	メンバー
助け	たすけ
布	ぬの
どうしようもない	どうしようもない
丁寧	ていねい
土	つち
たまたま	たまたま
だいぶ	だいぶ
下手	へた
永遠	えいえん
評価	ひょうか
景色	けしき
いくらでも	いくらでも
１人	ひとり
びっくり	びっくり
掛ける	かける
固まる	かたまる
美人	びじん
だらけ	だらけ
地獄	じごく
今に	いまに
この先	このさき
外れる	はずれる
翌日	よくじつ
小	しょう
埋める	うめる
動物	どうぶつ
隙間	すきま
いかが	いかが
油断	ゆだん
貫く	つらぬく
線	せん
申し訳ありません	もうしわけありません
続き	つづき
ついている	ついている
何だか	なんだか
氏	し
刺す	さす
見かける	みかける
控える	ひかえる
靴	くつ
特殊	とくしゅ
主人	しゅじん
つ	つ
目標	もくひょう
みたいです	みたいです
やり方	やりかた
傷つく	きずつく
教師	きょうし
他にも	ほかにも
青	あお
泳ぐ	およぐ
騒ぎ	さわぎ
届ける	とどける
おかげ	おかげ
派手	はで
崩す	くずす
仕掛ける	しかける
からこそ	からこそ
本日	ほんじつ
だいたい	だいたい
力	りょく
実力	じつりょく
踊る	おどる
次第	しだい
雲	くも
たびに	たびに
捕まる	つかまる
破る	やぶる
巻く	まく
もう一つ	もうひとつ
役目	やくめ
３人	さんにん
自慢	じまん
今でも	いまでも
駅	えき
要求	ようきゅう
高校	こうこう
手を出す	てをだす
そしたら	そしたら
ぶつける	ぶつける
範囲	はんい
戦	せん
どっか	どっか
その上	そのうえ
と言い	といい
顔色	かおいろ
音楽	おんがく
映画	えいが
仮に	かりに
鉄	てつ
今朝	けさ
プレゼント	プレゼント
自分から	じぶんから
ついてくる	ついてくる
あがる	あがる
追いつく	おいつく
環境	かんきょう
主張	しゅちょう
染まる	そまる
注ぐ	そそぐ
奇妙	きみょう
正解	せいかい
満たす	みたす
暴れる	あばれる
宿	やど
つくる	つくる
慎重	しんちょう
閉める	しめる
表	おもて
大勢	おおぜい
促す	うながす
と言えば	といえば
心から	こころから
暑い	あつい
持ち上げる	もちあげる
蹴る	ける
折れる	おれる
終了	しゅうりょう
台	だい
昼	ひる
いかにも	いかにも
安い	やすい
出発	しゅっぱつ
機能	きのう
言い出す	いいだす
南	みなみ
管理	かんり
性	せい
純粋	じゅんすい
こっそり	こっそり
草	くさ
卒業	そつぎょう
契約	けいやく
基本的	きほんてき
からかう	からかう
作品	さくひん
ふる	ふる
ショック	ショック
あう	あう
なんでもない	なんでもない
目覚める	めざめる
夕方	ゆうがた
爪	つめ
確保	かくほ
生き物	いきもの
現状	げんじょう
照らす	てらす
たら	たら
糸	いと
時々	ときどき
幸い	さいわい
やあ	やあ
足元	あしもと
せいか	せいか
枚	まい
連れて行く	つれていく
緑	みどり
次々	つぎつぎ
社会	しゃかい
感動	かんどう
字	じ
堂々	どうどう
突く	つく
トイレ	トイレ
といっても	といっても
収まる	おさまる
濃い	こい
あえて	あえて
子ども	こども
命じる	めいじる
しゃべる	しゃべる
買い物	かいもの
あちこち	あちこち
こんにちは	こんにちは
不幸	ふこう
虫	むし
ひたすら	ひたすら
橋	はし
述べる	のべる
からって	からって
具合	ぐあい
おかしな	おかしな
刻む	きざむ
かく	かく
舞台	ぶたい
教育	きょういく
生	なま
返る	かえる
ものである	ものである
機械	きかい
にて	にて
細かい	こまかい
ったら	ったら
だからって	だからって
徐々に	じょじょに
田	た
最低	さいてい
発表	はっぴょう
施設	しせつ
恋愛	れんあい
三つ	みっつ
品	ひん
法	ほう
集団	しゅうだん
脳	のう
太い	ふとい
夫婦	ふうふ
浮く	うく
顔を出す	かおをだす
おっと	おっと
千	せん
渡る	わたる
かまう	かまう
指摘	してき
隅	すみ
圧倒的	あっとうてき
招く	まねく
うまくいく	うまくいく
具体的	ぐたいてき
監視	かんし
喜び	よろこび
ルール	ルール
生きていく	いきていく
声を出す	こえをだす
譲る	ゆずる
派	は
男女	だんじょ
仲	なか
最中	さいちゅう
交渉	こうしょう
内部	ないぶ
時に	ときに
波	なみ
実家	じっか
説得	せっとく
会場	かいじょう
ある程度	あるていど
１つ	ひとつ
結論	けつろん
被害	ひがい
逃がす	にがす
素早い	すばやい
間もない	まもない
とっくに	とっくに
書類	しょるい
必要ない	ひつようない
共に	ともに
というのも	というのも
半ば	なかば
何もかも	なにもかも
浴びる	あびる
望み	のぞみ
生える	はえる
導く	みちびく
個人	こじん
代表	だいひょう
放っておく	ほうっておく
治療	ちりょう
直前	ちょくぜん
悟る	さとる
no	data
操作	そうさ
ほっと	ほっと
岩	いわ
やる気	やるき
単に	たんに
感想	かんそう
割れる	われる
ものすごい	ものすごい
狂う	くるう
下ろす	おろす
礼	れい
積む	つむ
生み出す	うみだす
容赦	ようしゃ
そうすれば	そうすれば
お客さん	おきゃくさん
あっという間に	あっというまに
整う	ととのう
稼ぐ	かせぐ
親しい	したしい
とのこと	とのこと
映像	えいぞう
残念ながら	ざんねんながら
会議	かいぎ
持っていく	もっていく
去年	きょねん
夢中	むちゅう
うえ	うえ
反省	はんせい
よほど	よほど
捉える	とらえる
接する	せっする
資料	しりょう
ときには	ときには
正面	しょうめん
この間	このあいだ
厄介	やっかい
預かる	あずかる
増やす	ふやす
時計	とけい
鳴らす	ならす
煙	けむり
交わす	かわす
達する	たっする
どうにも	どうにも
歯	は
だったり	だったり
休み	やすみ
移す	うつす
いかん	いかん
誓う	ちかう
おいで	おいで
つながる	つながる
に対し	にたいし
久しぶりに	ひさしぶりに
休憩	きゅうけい
重なる	かさなる
異なる	ことなる
段階	だんかい
逃れる	のがれる
もういい	もういい
もと	もと
登場	とうじょう
伏せる	ふせる
周辺	しゅうへん
目を覚ます	めをさます
人数	にんずう
移る	うつる
落ち込む	おちこむ
気にしない	きにしない
設定	せってい
一回	いっかい
辞める	やめる
侵入	しんにゅう
世間	せけん
仕方	しかた
居場所	いばしょ
互いに	たがいに
盛り上がる	もりあがる
発	はつ
都合	つごう
だんだん	だんだん
おや	おや
んな	んな
盗む	ぬすむ
お世話になる	おせわになる
処理	しょり
絡む	からむ
号	ごう
内側	うちがわ
もう一人	もうひとり
無意識	むいしき
湧く	わく
年間	ねんかん
奇跡	きせき
こりゃ	こりゃ
治る	なおる
医者	いしゃ
手に入る	てにはいる
強力	きょうりょく
一時	いちじ
一週間	いっしゅうかん
接触	せっしょく
お話し	おはなし
屋根	やね
自分自身	じぶんじしん
各	かく
個	こ
同意	どうい
角	かど
覚え	おぼえ
実感	じっかん
公園	こうえん
無	む
ですら	ですら
かつ	かつ
計算	けいさん
いまだ	いまだ
大声	おおごえ
乱暴	らんぼう
荒い	あらい
基本	きほん
世	よ
縁	えん
なるべく	なるべく
詰まる	つまる
三日	みっか
加わる	くわわる
さっぱり	さっぱり
縛る	しばる
何年	なんねん
強化	きょうか
データ	データ
謝罪	しゃざい
いちいち	いちいち
登る	のぼる
一斉に	いっせいに
ぜひ	ぜひ
材料	ざいりょう
しようとする	しようとする
ちょうだい	ちょうだい
掲げる	かかげる
常識	じょうしき
権利	けんり
昼間	ひるま
合図	あいず
飾る	かざる
ホテル	ホテル
誰でも	だれでも
だっけ	だっけ
両	りょう
意図	いと
一生懸命	いっしょうけんめい
つまらない	つまらない
溶ける	とける
運動	うんどう
見逃す	みのがす
もたらす	もたらす
負う	おう
正式	せいしき
どうかした	どうかした
実	じつ
何人	なんにん
とうとう	とうとう
市	し
いくつも	いくつも
以下	いか
貴重	きちょう
放す	はなす
通常	つうじょう
上る	のぼる
禁止	きんし
実験	じっけん
約	やく
してやる	してやる
晴れる	はれる
遊び	あそび
連続	れんぞく
狙い	ねらい
ページ	ページ
たとえば	たとえば
くだる	くだる
産む	うむ
力強い	ちからづよい
注文	ちゅうもん
どこにも	どこにも
とすると	とすると
倍	ばい
野	の
乗り込む	のりこむ
というと	というと
同情	どうじょう
楽しみにする	たのしみにする
こなす	こなす
秋	あき
尊敬	そんけい
復活	ふっかつ
上手	じょうず
における	における
中	じゅう
大	おお
生	せい
聴く	きく
ごく	ごく
解ける	とける
おとなしい	おとなしい
手足	てあし
野菜	やさい
だもの	だもの
となれば	となれば
尽くす	つくす
整理	せいり
日常	にちじょう
好み	このみ
どこまでも	どこまでも
汚れる	よごれる
泊まる	とまる
放置	ほうち
対策	たいさく
食べ物	たべもの
何でもない	なんでもない
いかに	いかに
ごとに	ごとに
そっくり	そっくり
複数	ふくすう
いいね	いいね
過ぎ	すぎ
浅い	あさい
若者	わかもの
呼びかける	よびかける
嫉妬	しっと
眠い	ねむい
拭く	ふく
理想	りそう
手前	てまえ
優先	ゆうせん
づらい	づらい
活躍	かつやく
と言っても	といっても
発揮	はっき
半年	はんとし
のんびり	のんびり
話し合う	はなしあう
交換	こうかん
いったん	いったん
痛む	いたむ
向き合う	むきあう
近寄る	ちかよる
開発	かいはつ
逆らう	さからう
拍手	はくしゅ
柱	はしら
種	くさ
がたい	がたい
によると	によると
その先	そのさき
単なる	たんなる
気味	きみ
でさえ	でさえ
犠牲	ぎせい
どおり	どおり
訪ねる	たずねる
引き受ける	ひきうける
詰める	つめる
資格	しかく
チェック	チェック
に似て	ににて
ある日	あるひ
玉	たま
愚か	おろか
せいぜい	せいぜい
癖	くせ
散る	ちる
維持	いじ
よっぽど	よっぽど
案外	あんがい
散歩	さんぽ
注目	ちゅうもく
お互いに	おたがいに
時間がかかる	じかんがかかる
今のところ	いまのところ
両方	りょうほう
便利	べんり
きく	きく
かねない	かねない
代わる	かわる
不自然	ふしぜん
どのよう	どのよう
転ぶ	ころぶ
恨む	うらむ
まいる	まいる
一般	いっぱん
乱れる	みだれる
前後	ぜんご
どうしたん	どうしたん
までもない	までもない
生じる	しょうじる
伺う	うかがう
聞かす	きかす
以降	いこう
引きずる	ひきずる
びっくりした	びっくりした
兄弟	きょうだい
体験	たいけん
ものになる	ものになる
自宅	じたく
強烈	きょうれつ
なさそう	なさそう
電車	でんしゃ
所属	しょぞく
今では	いまでは
たび	たび
ところへ	ところへ
応じる	おうじる
陥る	おちいる
始末	しまつ
乾く	かわく
真ん中	まんなか
ポイント	ポイント
旅行	りょこう
でして	でして
退屈	たいくつ
指す	さす
除く	のぞく
生命	せいめい
手伝い	てつだい
飽きる	あきる
かぶる	かぶる
そのあと	そのあと
魅力	みりょく
乗り越える	のりこえる
役割	やくわり
飯	めし
犯す	おかす
葉	は
持ち主	もちぬし
根	ね
きっかけ	きっかけ
苦痛	くつう
悲しみ	かなしみ
丸	まる
これら	これら
方々	かたがた
もったいない	もったいない
疑い	うたがい
危機	きき
選択肢	せんたくし
特徴	とくちょう
汚い	きたない
停止	ていし
一杯	いっぱい
くっつく	くっつく
伴う	ともなう
変更	へんこう
に比べ	にくらべ
数える	かぞえる
ゼロ	ゼロ
等	とう
挙げる	あげる
勘弁	かんべん
事前	じぜん
いっそ	いっそ
とう	とう
証	あかし
跡	あと
実行	じっこう
抜け出す	ぬけだす
相手にする	あいてにする
次第に	しだいに
勝ち	かち
化	か
対	たい
一方的	いっぽうてき
酔う	よう
ふう	ふう
商品	しょうひん
上下	じょうげ
惜しい	おしい
おめでとう	おめでとう
下る	くだる
かと思うと	かとおもうと
初	はつ
順調	じゅんちょう
優れる	すぐれる
誇る	ほこる
調整	ちょうせい
対処	たいしょ
夢を見る	ゆめをみる
二度	にど
困難	こんなん
グループ	グループ
バランス	バランス
追加	ついか
割る	わる
雇う	やとう
愛情	あいじょう
がち	がち
服装	ふくそう
スピード	スピード
no	data
主に	おもに
べく	べく
豊か	ゆたか
悩み	なやみ
棚	たな
あたる	あたる
感じがする	かんじがする
を通して	をとおして
この手	このて
保証	ほしょう
設置	せっち
近所	きんじょ
再開	さいかい
ぴったり	ぴったり
疲れ	つかれ
体調	たいちょう
かなう	かなう
対する	たいする
どちらも	どちらも
容易	ようい
できるだけ	できるだけ
頭から	あたまから
用いる	もちいる
付近	ふきん
筋	すじ
数字	すうじ
務める	つとめる
追い出す	おいだす
施す	ほどこす
叱る	しかる
にしておく	にしておく
要素	ようそ
安定	あんてい
およそ	およそ
アメリカ	アメリカ
場面	ばめん
一種	いっしゅ
季節	きせつ
こもる	こもる
添える	そえる
にもかかわらず	にもかかわらず
風景	ふうけい
かねる	かねる
しつこい	しつこい
新聞	しんぶん
不明	ふめい
今頃	いまごろ
かわいそう	かわいそう
憎む	にくむ
積極的	せっきょくてき
前回	ぜんかい
真の	しんの
成果	せいか
に従って	にしたがって
収める	おさめる
必要とする	ひつようとする
保護	ほご
成立	せいりつ
日本人	にほんじん
下す	くだす
申し上げる	もうしあげる
あちら	あちら
評判	ひょうばん
一面	いちめん
関係者	かんけいしゃ
ふさわしい	ふさわしい
個人的	こじんてき
うそ	うそ
生かす	いかす
いつから	いつから
入り込む	はいりこむ
年上	としうえ
最終的	さいしゅうてき
拒否	きょひ
セット	セット
家庭	かてい
明確	めいかく
特定	とくてい
出てくる	でてくる
はるか	はるか
そういうもの	そういうもの
決断	けつだん
欠ける	かける
地位	ちい
想定	そうてい
歓迎	かんげい
曲がる	まがる
たって	たって
表面	ひょうめん
不足	ふそく
でないと	でないと
２つ	ふたつ
近づける	ちかづける
提供	ていきょう
経過	けいか
熱心	ねっしん
出入り	でいり
処分	しょぶん
載る	のる
下	か
no	data
載せる	のせる
規模	きぼ
意味がある	いみがある
つまる	つまる
詳細	しょうさい
何回	なんかい
うる	うる
地域	ちいき
好む	このむ
悲しむ	かなしむ
よす	よす
始まり	はじまり
親子	おやこ
皮	かわ
備える	そなえる
持ち込む	もちこむ
成績	せいせき
指定	してい
頼み	たのみ
中には	なかには
一見	いっけん
固める	かためる
この中	このなか
地方	ちほう
世界中	せかいじゅう
念のため	ねんのため
大事にする	だいじにする
義務	ぎむ
世話	せわ
肝心	かんじん
見に行く	みにいく
塗る	ぬる
なしに	なしに
うっかり	うっかり
対抗	たいこう
本格的	ほんかくてき
身につける	みにつける
模様	もよう
おしまい	おしまい
発展	はってん
キロ	キロ
記す	しるす
作り	つくり
ところから	ところから
性質	せいしつ
どうしたらいい	どうしたらいい
慰める	なぐさめる
いざ	いざ
分かれる	わかれる
代わり	かわり
出会い	であい
座	ざ
入り	いり
出身	しゅっしん
案	あん
当初	とうしょ
実現	じつげん
文化	ぶんか
変わり	かわり
一定	いってい
目に見える	めにみえる
したる	したる
教わる	おそわる
引き出す	ひきだす
かえって	かえって
指導	しどう
深刻	しんこく
一般的	いっぱんてき
表す	あらわす
期間	きかん
じっくり	じっくり
築く	きずく
精神的	せいしんてき
ほかに	ほかに
逃す	のがす
極めて	きわめて
焼ける	やける
敷く	しく
負担	ふたん
方針	ほうしん
小学校	しょうがっこう
争い	あらそい
争う	あらそう
賛成	さんせい
経る	へる
姿を見せる	すがたをみせる
取り上げる	とりあげる
というものは	というものは
尽きる	つきる
新鮮	しんせん
思い切る	おもいきる
ものなら	ものなら
持ち出す	もちだす
重大	じゅうだい
共有	きょうゆう
勧める	すすめる
いいところ	いいところ
暮らし	くらし
日	にち
外	がい
大切にする	たいせつにする
抗議	こうぎ
割	わり
解釈	かいしゃく
夜中	よなか
一致	いっち
健康	けんこう
大いに	おおいに
その他	そのほか
にやっ	にやっ
余り	あまり
社	しゃ
苦しみ	くるしみ
挑戦	ちょうせん
何十	なんじゅう
建てる	たてる
高まる	たかまる
よく言う	よくいう
毎年	まいとし
歩む	あゆむ
根拠	こんきょ
よそ	よそ
数々	かずかず
午前	ごぜん
高める	たかめる
余地	よち
来年	らいねん
足る	たる
からには	からには
利益	りえき
つれる	つれる
英語	えいご
最終	さいしゅう
中でも	なかでも
厚い	あつい
改める	あらためる
ケース	ケース
悪くなる	わるくなる
習う	ならう
達成	たっせい
前提	ぜんてい
帰す	かえす
減らす	へらす
つなぐ	つなぐ
分析	ぶんせき
ともに	ともに
役立つ	やくだつ
一時的	いちじてき
長年	ながねん
よくある	よくある
生涯	しょうがい
大胆	だいたん
こうした	こうした
こだわる	こだわる
共通	きょうつう
制限	せいげん
質	しつ
多数	たすう
さまざま	さまざま
定める	さだめる
外出	がいしゅつ
徹底的	てっていてき
比較的	ひかくてき
実際は	じっさいは
まとまる	まとまる
地元	じもと
恵まれる	めぐまれる
経営	けいえい
中止	ちゅうし
検討	けんとう
働き	はたらき
引き上げる	ひきあげる
提出	ていしゅつ
非難	ひなん
数年	すうねん
だく	だく
よくなる	よくなる
強める	つよめる
専門	せんもん
海外	かいがい
向け	むけ
行方	ゆくえ
傾向	けいこう
ものにする	ものにする
以内	いない
はじめ	はじめ
後半	こうはん
関連	かんれん
議論	ぎろん
拡大	かくだい
設ける	もうける
努める	つとめる
出席	しゅっせき
全国	ぜんこく
背景	はいけい
基準	きじゅん
どのように	どのように
思うように	おもうように
no	data
身近	みぢか
幅	はば
強調	きょうちょう
見直す	みなおす
占める	しめる
はぁ	はぁ
あたし	あたし
魔法	まほう
頷く	うなずく
剣	けん
呟く	つぶやく
微笑む	ほほえむ
ふふ	ふふ
撫でる	なでる
貴様	きさま
っす	っす
キス	キス
眼	め
屋敷	やしき
居る	いる
美味しい	おいしい
貴族	きぞく
掴む	つかむ
すいません	すいません
顔を上げる	かおをあげる
戦闘	せんとう
貰う	もらう
騎士	きし
よー	よー
魔	ま
軍	ぐん
魔力	まりょく
撃つ	うつ
王子	おうじ
ああああ	ああああ
凄い	すごい
更に	さらに
獣	けもの
苦笑	くしょう
デート	デート
呆れる	あきれる
手を伸ばす	てをのばす
己	おのれ
拳	こぶし
指先	ゆびさき
漏らす	もらす
喋る	しゃべる
悪魔	あくま
わたくし	わたくし
睨む	にらむ
声を上げる	こえをあげる
ふむ	ふむ
見開く	みひらく
上手い	うまい
お兄ちゃん	おにいちゃん
御	ご
お腹	おなか
何故	なぜ
溢れる	あふれる
見下ろす	みおろす
はは	はは
老人	ろうじん
一同	いちどう
死体	したい
為	ため
青年	せいねん
学園	がくえん
元々	もともと
口元	くちもと
舐める	なめる
戸惑う	とまどう
お姉ちゃん	おねえちゃん
ママ	ママ
母さん	かあさん
携帯	けいたい
音を立てる	おとをたてる
ははは	ははは
姫	ひめ
四人	よにん
一撃	いちげき
殿	どの
ヤツ	ヤツ
お前ら	おまえら
うわっ	うわっ
おれ	おれ
抱きしめる	だきしめる
まぁ	まぁ
気持ちいい	きもちいい
ある人	あるひと
おおう	おおう
うわあ	うわあ
わし	わし
うむ	うむ
ねー	ねー
ホント	ホント
さぁ	さぁ
うなずく	うなずく
くん	くん
おまえ	おまえ
no	data
震わせる	ふるわせる
首を振る	くびをふる
野郎	やろう
肉体	にくたい
操る	あやつる
っち	っち
恐らく	おそらく
想い	おもい
フッ	フッ
目を閉じる	めをとじる
ポケット	ポケット
馬車	ばしゃ
撮る	とる
私達	わたしたち
ええっ	ええっ
ナイフ	ナイフ
親父	おやじ
ヤバい	ヤバい
兵士	へいし
矢	や
見回す	みまわす
護衛	ごえい
兵	へい
ってば	ってば
首を傾げる	くびをかしげる
酷い	ひどい
ちょっ	ちょっ
今更	いまさら
ドレス	ドレス
王国	おうこく
あはは	あはは
パパ	パパ
手を振る	てをふる
くそ	くそ
怯える	おびえる
飲み込む	のみこむ
程	ほど
照れる	てれる
ノック	ノック
戦場	せんじょう
斬る	きる
内心	ないしん
脚	あし
技	わざ
スカート	スカート
安堵	あんど
顎	あご
メール	メール
最強	さいきょう
貴方	あなた
脇	わき
人類	じんるい
お姉さん	おねえさん
囁く	ささやく
騙す	だます
とやら	とやら
塊	かたまり
呆然	ぼうぜん
チーム	チーム
お菓子	おかし
部隊	ぶたい
訊く	きく
発動	はつどう
呪い	のろい
試合	しあい
でしたら	でしたら
槍	やり
繋がる	つながる
やれやれ	やれやれ
弾く	ひく
僕たち	ぼくたち
みたいだ	みたいだ
なー	なー
僕ら	ぼくら
ええと	ええと
気持ちよい	きもちよい
ホントに	ホントに
ていうか	ていうか
たしかに	たしかに
おはようございます	おはようございます
おじさん	おじさん
お前たち	おまえたち
奴ら	やつら
ほんとに	ほんとに
君たち	きみたち
ふたり	ふたり
けれども	けれども
ため息をつく	ためいきをつく
がんばる	がんばる
つぶやく	つぶやく
立ち止まる	たちどまる
ことが出来る	ことができる
モノ	モノ
ハッ	ハッ
アレ	アレ
お嬢様	おじょうさま
ため息	ためいき
ぼく	ぼく
かなあ	かなあ
城	じょう
伝説	でんせつ
銃	じゅう
盾	たて
駆け寄る	かけよる
無数	むすう
喧嘩	けんか
通路	つうろ
父さん	とうさん
天使	てんし
可愛らしい	かわいらしい
見渡す	みわたす
地図	ちず
傍	そば
大人しい	おとなしい
揺らす	ゆらす
困惑	こんわく
隊	たい
イベント	イベント
あのね	あのね
吐き出す	はきだす
目を向ける	めをむける
昨夜	ゆうべ
刀	かたな
気持ち悪い	きもちわるい
回収	かいしゅう
室内	しつない
脱出	だっしゅつ
竜	りゅう
画面	がめん
銀	ぎん
無茶	むちゃ
舞う	まう
夕食	ゆうしょく
歪む	ゆがむ
不意	ふい
刃	は
布団	ふとん
天才	てんさい
唐突	とうとつ
手に取る	てにとる
らしき	らしき
メイド	メイド
曲	きょく
親友	しんゆう
出現	しゅつげん
風呂	ふろ
任務	にんむ
ドキドキ	ドキドキ
膨らむ	ふくらむ
下着	したぎ
奥さん	おくさん
人影	ひとかげ
翼	つばさ
社長	しゃちょう
ダメージ	ダメージ
回避	かいひ
大地	だいち
染める	そめる
僅か	わずか
頭上	ずじょう
威力	いりょく
遮る	さえぎる
振り回す	ふりまわす
ったく	ったく
言う通り	いうとおり
目を細める	めをほそめる
サイズ	サイズ
攻める	せめる
試験	しけん
不機嫌	ふきげん
鍛える	きたえる
朝食	ちょうしょく
途端	とたん
地球	ちきゅう
かもしれん	かもしれん
食堂	しょくどう
気が付く	きがつく
店員	てんいん
カード	カード
もしもし	もしもし
ぎゅっと	ぎゅっと
一発	いっぱつ
うんうん	うんうん
教会	きょうかい
やばい	やばい
フフ	フフ
まえ	まえ
お父様	おとうさま
こいつら	こいつら
子供たち	こどもたち
かなぁ	かなぁ
問い	とい
そりゃあ	そりゃあ
ガキ	ガキ
コーヒー	コーヒー
ふふふ	ふふふ
なんだと	なんだと
あなたたち	あなたたち
押しつける	おしつける
様	ざま
小説	しょうせつ
眉	まゆ
小声	こごえ
拭う	ぬぐう
防御	ぼうぎょ
生き残る	いきのこる
皿	さら
五十	ごじゅう
バイト	バイト
彼氏	かれし
筋肉	きんにく
紅茶	こうちゃ
衣装	いしょう
突き出す	つきだす
罠	わな
片付ける	かたづける
駆ける	かける
充分	じゅうぶん
被害者	ひがいしゃ
卵	たまご
何やら	なにやら
カメラ	カメラ
混じる	まじる
空中	くうちゅう
匹	ひき
生物	せいぶつ
合流	ごうりゅう
足を止める	あしをとめる
いやあ	いやあ
再会	さいかい
羨ましい	うらやましい
二階	にかい
仕草	しぐさ
回転	かいてん
師匠	ししょう
跳ねる	はねる
お客様	おきゃくさま
待機	たいき
ほんの少し	ほんのすこし
即座に	そくざに
完了	かんりょう
手元	てもと
吸い込む	すいこむ
パーティー	パーティー
誕生日	たんじょうび
テスト	テスト
動作	どうさ
てめえ	てめえ
暴走	ぼうそう
お風呂	おふろ
言い切る	いいきる
気まずい	きまずい
挑む	いどむ
枝	えだ
台詞	せりふ
帯びる	おびる
女神	めがみ
片方	かたほう
反論	はんろん
返答	へんとう
黒髪	くろかみ
大会	たいかい
互い	たがい
鎧	よろい
噛む	かむ
ちらり	ちらり
袖	そで
装備	そうび
異様	いよう
迷い	まよい
戦力	せんりょく
体勢	たいせい
後方	こうほう
見覚え	みおぼえ
暗闇	くらやみ
輝き	かがやき
背を向ける	せをむける
屋上	おくじょう
曖昧	あいまい
システム	システム
お尻	おしり
わっ	わっ
のう	のう
無理やり	むりやり
かすか	かすか
問いかける	といかける
でござる	でござる
はいる	はいる
真っ白	まっしろ
手のひら	てのひら
越し	ごし
すなわち	すなわち
抱きつく	だきつく
気のせい	きのせい
見合わせる	みあわせる
ボタン	ボタン
めちゃくちゃ	めちゃくちゃ
イヤ	イヤ
ふーん	ふーん
no	data
身分	みぶん
砂	すな
都市	とし
第三	だいさん
師	し
旦那	だんな
不気味	ぶきみ
美	び
眼差し	まなざし
歓声	かんせい
時刻	じこく
ケーキ	ケーキ
宙	ちゅう
群れ	むれ
霧	きり
桜	さくら
手首	てくび
後にする	あとにする
素材	そざい
精一杯	せいいっぱい
広場	ひろば
裾	すそ
叶う	かなう
何となく	なんとなく
表示	ひょうじ
万が一	まんがいち
やけに	やけに
嵐	あらし
明かり	あかり
復讐	ふくしゅう
妄想	もうそう
変態	へんたい
宝石	ほうせき
具	ぐ
追い詰める	おいつめる
拘束	こうそく
そんな風に	そんなふうに
どうかな	どうかな
踏み込む	ふみこむ
かも知れない	かもしれない
理屈	りくつ
滑る	すべる
英雄	えいゆう
先端	せんたん
まあまあ	まあまあ
ミス	ミス
針	はり
前方	ぜんぽう
窺う	うかがう
聖	せい
一時間	いちじかん
襲撃	しゅうげき
放課後	ほうかご
髪の毛	かみのけ
見捨てる	みすてる
覗き込む	のぞきこむ
故郷	こきょう
崩壊	ほうかい
嫌がる	いやがる
めく	めく
背筋	せすじ
民	たみ
推測	すいそく
選手	せんしゅ
じゃねぇ	じゃねぇ
いつも通り	いつもどおり
予想外	よそうがい
現象	げんしょう
無表情	むひょうじょう
淡々	たんたん
声がする	こえがする
三年	さんねん
陣	じん
息を吐く	いきをつく
へぇ	へぇ
ひとまず	ひとまず
ハハハ	ハハハ
握りしめる	にぎりしめる
立ち去る	たちさる
ウソ	ウソ
いい加減	いいかげん
かっ	かっ
引っかかる	ひっかかる
言うとおり	いうとおり
クソ	クソ
たどり着く	たどりつく
振るう	ふるう
ちがう	ちがう
いつもより	いつもより
おおい	おおい
今さら	いまさら
もしくは	もしくは
指さす	ゆびさす
ガラス	ガラス
果たして	はたして
ふうん	ふうん
やたら	やたら
なんとも	なんとも
やり取り	やりとり
歳	とし
no	data
一旦	いったん
に過ぎない	にすぎない
メッセージ	メッセージ
寸前	すんぜん
その辺	そのへん
目にする	めにする
とて	とて
四十	よんじゅう
正義	せいぎ
胸元	むなもと
冷える	ひえる
裸	はだか
なぜなら	なぜなら
棒	ぼう
ビル	ビル
皮肉	ひにく
巡る	めぐる
淡い	あわい
憧れる	あこがれる
杖	つえ
事になる	ことになる
そこそこ	そこそこ
塞ぐ	ふさぐ
本来なら	ほんらいなら
薄暗い	うすぐらい
動き出す	うごきだす
柄	がら
削る	けずる
幽霊	ゆうれい
かもね	かもね
お酒	おさけ
封印	ふういん
獲物	えもの
若干	じゃっかん
候補	こうほ
誤魔化す	ごまかす
再生	さいせい
宿る	やどる
ぐっと	ぐっと
ギリギリ	ギリギリ
女王	じょおう
姿を消す	すがたをけす
シャツ	シャツ
継ぐ	つぐ
キャラ	キャラ
途端に	とたんに
致す	いたす
食らう	くらう
ネット	ネット
懐	ふところ
蛇	へび
要するに	ようするに
走り出す	はしりだす
デザイン	デザイン
向き直る	むきなおる
怪物	かいぶつ
何人か	なんにんか
ゆえ	ゆえ
腐る	くさる
辿り着く	たどりつく
冷める	さめる
はーい	はーい
仮面	かめん
見据える	みすえる
唱える	となえる
通り過ぎる	とおりすぎる
谷	たに
何故か	なぜか
宇宙	うちゅう
金髪	きんぱつ
主人公	しゅじんこう
鈍い	にぶい
叫び	さけび
この辺り	このあたり
ルート	ルート
二日	ふつか
犯罪	はんざい
首を横に振る	くびをよこにふる
外見	がいけん
売れる	うれる
雷	かみなり
接近	せっきん
演技	えんぎ
真っ直ぐ	まっすぐ
ばっか	ばっか
しばし	しばし
んち	んち
しがみつく	しがみつく
引き寄せる	ひきよせる
それどころか	それどころか
化け物	ばけもの
セリフ	セリフ
叩きつける	たたきつける
なんだって	なんだって
付き	つき
とある	とある
マシ	マシ
さっそく	さっそく
戦	いくさ
解除	かいじょ
危うい	あやうい
地味	じみ
兄さん	にいさん
自殺	じさつ
ソファ	ソファ
灰色	はいいろ
吹き飛ばす	ふきとばす
倉庫	そうこ
金色	きんいろ
幸福	こうふく
押し付ける	おしつける
考え込む	かんがえこむ
治す	なおす
夏休み	なつやすみ
正面から	しょうめんから
儀式	ぎしき
舌打ち	したうち
中学	ちゅうがく
本心	ほんしん
折る	おる
尻尾	しっぽ
消滅	しょうめつ
耳元	みみもと
ファン	ファン
狼	おおかみ
本音	ほんね
リーダー	リーダー
姿を現す	すがたをあらわす
一族	いちぞく
ちっ	ちっ
ゆえに	ゆえに
エネルギー	エネルギー
欲望	よくぼう
配置	はいち
お兄さん	おにいさん
田舎	いなか
会長	かいちょう
この辺	このへん
小学生	しょうがくせい
十五	じゅうご
お疲れ	おつかれ
てっきり	てっきり
負け	まけ
部長	ぶちょう
手渡す	てわたす
眼鏡	めがね
キラキラ	キラキラ
堪える	こらえる
吐息	といき
目が覚める	めがさめる
でかい	でかい
雑誌	ざっし
帽子	ぼうし
警備	けいび
器用	きよう
校舎	こうしゃ
どく	どく
両腕	りょううで
商売	しょうばい
突破	とっぱ
身長	しんちょう
気を付ける	きをつける
お嬢さん	おじょうさん
戦士	せんし
漫画	まんが
姉妹	しまい
金属	きんぞく
言い聞かせる	いいきかせる
指輪	ゆびわ
閉じ込める	とじこめる
足取り	あしどり
目が合う	めがあう
商人	しょうにん
奴隷	どれい
塔	とう
羽	はね
ぽい	ぽい
起き上がる	おきあがる
俯く	うつむく
１人で	ひとりで
響き	ひびき
ご存じ	ごぞんじ
ごとく	ごとく
ノ	ノ
すぐさま	すぐさま
ちょうどいい	ちょうどいい
おー	おー
ありえない	ありえない
ごとき	ごとき
こぼれる	こぼれる
ごまかす	ごまかす
こぼす	こぼす
えーと	えーと
連れていく	つれていく
お疲れさま	おつかれさま
えらい	えらい
思いっきり	おもいっきり
はじめて	はじめて
書	しょ
捧げる	ささげる
素人	しろうと
快感	かいかん
無論	むろん
患者	かんじゃ
神経	しんけい
級	きゅう
ひょっとして	ひょっとして
見慣れる	みなれる
叶える	かなえる
怒鳴る	どなる
ノート	ノート
幻	まぼろし
這う	はう
二本	にほん
遭遇	そうぐう
メニュー	メニュー
断言	だんげん
乙女	おとめ
仕える	つかえる
制御	せいぎょ
大半	たいはん
さえも	さえも
値段	ねだん
兄貴	あにき
手を引く	てをひく
階	かい
力になる	ちからになる
すげえ	すげえ
見知る	みしる
プロ	プロ
微笑	びしょう
毛	け
そうなんです	そうなんです
尻	しり
想う	おもう
丸い	まるい
落下	らっか
どう見ても	どうみても
後輩	こうはい
理性	りせい
策	さく
カップ	カップ
部活	ぶかつ
出口	でぐち
驚愕	きょうがく
お昼	おひる
えへへ	えへへ
そうなると	そうなると
であります	であります
引き抜く	ひきぬく
加速	かそく
封じる	ふうじる
類	るい
なき	なき
横たわる	よこたわる
へへ	へへ
目を丸くする	めをまるくする
微か	かすか
服を着る	ふくをきる
数人	すうにん
高校生	こうこうせい
十年	じゅうねん
逸らす	そらす
一口	ひとくち
液体	えきたい
排除	はいじょ
閉まる	しまる
池	いけ
見抜く	みぬく
疲労	ひろう
士	し
祝福	しゅくふく
手放す	てばなす
咲く	さく
団	だん
故	ゆえ
これくらい	これくらい
睨みつける	にらみつける
意味がない	いみがない
気はない	きはない
わたしたち	わたしたち
時折	ときおり
いつだって	いつだって
声をあげる	こえをあげる
ひとりで	ひとりで
ばか	ばか
はしゃぐ	はしゃぐ
ずるい	ずるい
その代わり	そのかわり
フフフ	フフフ
少なくとも	すくなくとも
俺ら	おれら
はあっ	はあっ
使い	つかい
やだ	やだ
まつ	まつ
１年	いちねん
見せつける	みせつける
フォロー	フォロー
絞る	しぼる
好きにする	すきにする
いえいえ	いえいえ
固定	こてい
戸	と
嫁	よめ
不審	ふしん
同行	どうこう
鞄	かばん
飼う	かう
要る	いる
センチ	センチ
畑	はたけ
電気	でんき
孤独	こどく
婚約	こんやく
予測	よそく
肯定	こうてい
そうなんですか	そうなんですか
上空	じょうくう
カウンター	カウンター
被る	かぶる
先程	さきほど
グラス	グラス
っきり	っきり
一匹	いっぴき
状	じょう
柔らか	やわらか
住人	じゅうにん
平然	へいぜん
心底	しんそこ
拒絶	きょぜつ
男の人	おとこのひと
横顔	よこがお
孫	まご
きっちり	きっちり
牙	きば
散々	さんざん
目撃	もくげき
ボール	ボール
躊躇	ちゅうちょ
滲む	にじむ
悲鳴を上げる	ひめいをあげる
捜査	そうさ
本能	ほんのう
木々	きぎ
指差す	ゆびさす
国家	こっか
購入	こうにゅう
賭ける	かける
皆様	みなさま
無邪気	むじゃき
幸運	こううん
帰って来る	かえってくる
友	とも
見張る	みはる
報酬	ほうしゅう
深呼吸	しんこきゅう
大人になる	おとなになる
ただでさえ	ただでさえ
作り出す	つくりだす
餌	えさ
間近	まぢか
着替え	きがえ
お帰り	おかえり
微笑み	ほほえみ
使い方	つかいかた
鳴く	なく
途切れる	とぎれる
出迎える	でむかえる
器	うつわ
高	こう
マスター	マスター
利く	きく
右腕	みぎうで
めくる	めくる
単語	たんご
だろうに	だろうに
ある意味	あるいみ
胸を張る	むねをはる
纏う	まとう
早々	そうそう
いじめる	いじめる
溜まる	たまる
っぱなし	っぱなし
腰を下ろす	こしをおろす
駆けつける	かけつける
早め	はやめ
けっこう	けっこう
たしか	たしか
かしこまる	かしこまる
飲み物	のみもの
いつの間に	いつのまに
のあまり	のあまり
ゴミ	ゴミ
同じくらい	おなじくらい
捕らえる	とらえる
ちっとも	ちっとも
アホ	アホ
暖かい	あたたかい
忠告	ちゅうこく
無意味	むいみ
騒がしい	さわがしい
脳裏	のうり
悪	あく
透明	とうめい
響き渡る	ひびきわたる
傾く	かたむく
仰ぐ	あおぐ
暴力	ぼうりょく
晩	ばん
お邪魔	おじゃま
領域	りょういき
小柄	こがら
お弁当	おべんとう
お休み	おやすみ
看板	かんばん
感じ取る	かんじとる
そう言えば	そういえば
是非	ぜひ
カーテン	カーテン
メモ	メモ
勘	かん
大抵	たいてい
数十	すうじゅう
方面	ほうめん
植物	しょくぶつ
確率	かくりつ
例外	れいがい
支度	したく
罰	ばつ
こちらこそ	こちらこそ
演じる	えんじる
造る	つくる
避難	ひなん
入学	にゅうがく
お手伝い	おてつだい
美少女	びしょうじょ
誇り	ほこり
丘	おか
突き刺さる	つきささる
首筋	くびすじ
口に出す	くちにだす
興味深い	きょうみぶかい
弟子	でし
見当たる	みあたる
板	いた
反撃	はんげき
心の底	こころのそこ
唸る	うなる
トラブル	トラブル
しめる	しめる
所詮	しょせん
撮影	さつえい
一点	いってん
呪う	のろう
小屋	こや
汚す	よごす
その頃	そのころ
うふふ	うふふ
no	data
それはそれで	それはそれで
くそっ	くそっ
誘い	さそい
浮かび上がる	うかびあがる
遠ざかる	とおざかる
文句を言う	もんくをいう
店内	てんない
はっと	はっと
通信	つうしん
悪意	あくい
通用	つうよう
構成	こうせい
押し込む	おしこむ
当日	とうじつ
贈る	おくる
説教	せっきょう
つる	つる
あく	あく
好く	すく
襲いかかる	おそいかかる
鳴き声	なきごえ
いい子	いいこ
おもしろい	おもしろい
引き取る	ひきとる
あのさ	あのさ
ケンカ	ケンカ
顔をしかめる	かおをしかめる
どれくらい	どれくらい
おまけに	おまけに
のぞく	のぞく
ハハ	ハハ
手をかける	てをかける
１回	いっかい
だからといって	だからといって
突きつける	つきつける
さすがは	さすがは
あり得ない	ありえない
何らか	なんらか
歩み寄る	あゆみよる
等しい	ひとしい
垂れる	たれる
敏感	びんかん
深夜	しんや
輪	わ
鍋	なべ
この後	このあと
装う	よそおう
攻略	こうりゃく
億	おく
不快	ふかい
体重	たいじゅう
専用	せんよう
眉間	みけん
付き合い	つきあい
昇る	のぼる
湯	ゆ
晒す	さらす
残酷	ざんこく
放る	ほうる
歩	ほ
錯覚	さっかく
誘導	ゆうどう
救い	すくい
優雅	ゆうが
切り替える	きりかえる
罪悪感	ざいあくかん
気絶	きぜつ
理不尽	りふじん
好意	こうい
沢山	たくさん
国民	こくみん
財布	さいふ
事務所	じむしょ
ああいう	ああいう
憧れ	あこがれ
魅力的	みりょくてき
人質	ひとじち
列	れつ
臭い	くさい
修行	しゅぎょう
率いる	ひきいる
怪訝	けげん
盛大	せいだい
職業	しょくぎょう
同然	どうぜん
腕を組む	うでをくむ
容姿	ようし
鎖	くさり
締める	しめる
内緒	ないしょ
反射的	はんしゃてき
パターン	パターン
到達	とうたつ
一件	いっけん
どう考えても	どうかんがえても
いい人	いいひと
装置	そうち
教授	きょうじゅ
包み込む	つつみこむ
衝動	しょうどう
尖る	とがる
親切	しんせつ
目に入る	めにはいる
ベンチ	ベンチ
埋まる	うまる
礼を言う	れいをいう
弾	たま
ニュース	ニュース
パンツ	パンツ
緩む	ゆるむ
潜む	ひそむ
はっきり言う	はっきりいう
再度	さいど
そうじゃなくて	そうじゃなくて
逮捕	たいほ
傍ら	かたわら
タオル	タオル
名誉	めいよ
配る	くばる
食	しょく
どうするか	どうするか
横目	よこめ
何とも	なんとも
医師	いし
界	かい
肩をすくめる	かたをすくめる
大げさ	おおげさ
おばさん	おばさん
心地よい	ここちよい
やりとり	やりとり
あふれる	あふれる
あくまでも	あくまでも
そんなふうに	そんなふうに
おかえり	おかえり
滅ぼす	ほろぼす
凄まじい	すさまじい
燃やす	もやす
そうだよね	そうだよね
額	ひたい
入口	いりぐち
文章	ぶんしょう
手を取る	てをとる
我に返る	われにかえる
茶	ちゃ
顔立ち	かおだち
その分	そのぶん
鼓動	こどう
貼る	はる
頭を抱える	あたまをかかえる
台所	だいどころ
相応しい	ふさわしい
人達	ひとたち
現代	げんだい
ネタ	ネタ
掌	てのひら
弁当	べんとう
顔面	がんめん
流	りゅう
何にも	なんにも
お母様	おかあさま
目線	めせん
権力	けんりょく
突入	とつにゅう
昼食	ちゅうしょく
十二	じゅうに
なのである	なのである
事がある	ことがある
気遣う	きづかう
ズボン	ズボン
苦い	にがい
覚悟を決める	かくごをきめる
思い込む	おもいこむ
親戚	しんせき
意地悪	いじわる
遥か	はるか
大陸	たいりく
お湯	おゆ
加減	かげん
物音	ものおと
祖父	そふ
発想	はっそう
ハンカチ	ハンカチ
敗北	はいぼく
シンプル	シンプル
モデル	モデル
深々	ふかぶか
無限	むげん
足を踏み入れる	あしをふみいれる
見失う	みうしなう
お任せ	おまかせ
潰れる	つぶれる
食料	しょくりょう
数秒	すうびょう
バラバラ	バラバラ
テンション	テンション
上昇	じょうしょう
消費	しょうひ
言	げん
脅す	おどす
帰れ	かえれ
記事	きじ
顔を合わせる	かおをあわせる
混ぜる	まぜる
係	かかり
伝う	つたう
叫び声	さけびごえ
未だ	まだ
寝室	しんしつ
夫人	ふじん
無理矢理	むりやり
らっしゃる	らっしゃる
高級	こうきゅう
脅威	きょうい
緩める	ゆるめる
すく	すく
上司	じょうし
用件	ようけん
調子に乗る	ちょうしにのる
遅刻	ちこく
食材	しょくざい
試みる	こころみる
横になる	よこになる
つきあう	つきあう
取引	とりひき
何かしら	なにかしら
３年	さんねん
かた	かた
おなか	おなか
あける	あける
ホッと	ホッと
言いかける	いいかける
たたく	たたく
顔つき	かおつき
鮮やか	あざやか
そろう	そろう
お言葉	おことば
いちばん	いちばん
そんなもん	そんなもん
no	data
度	たび
街	がい
no	data
刃	やいば
恨み	うらみ
曲げる	まげる
いじる	いじる
差す	さす
到底	とうてい
繋ぐ	つなぐ
プライド	プライド
職人	しょくにん
像	ぞう
枕	まくら
差し込む	さしこむ
図書館	としょかん
可能性が高い	かのうせいがたかい
同時	どうじ
弱点	じゃくてん
おっさん	おっさん
政府	せいふ
確定	かくてい
矛盾	むじゅん
泣き声	なきごえ
振動	しんどう
真っ先に	まっさきに
自転車	じてんしゃ
耳にする	みみにする
帰宅	きたく
目的地	もくてきち
再現	さいげん
拒む	こばむ
無力	むりょく
林	はやし
愉快	ゆかい
言い放つ	いいはなつ
値	あたい
揃える	そろえる
死亡	しぼう
苦笑い	にがわらい
任す	まかす
ふっと	ふっと
塩	しお
ボロボロ	ボロボロ
賢い	かしこい
あの頃	あのころ
銀色	ぎんいろ
磨く	みがく
静寂	せいじゃく
夜空	よぞら
眩しい	まぶしい
自己紹介	じこしょうかい
構造	こうぞう
にっこり	にっこり
大型	おおがた
工場	こうじょう
手配	てはい
切り裂く	きりさく
黄金	おうごん
先頭	せんとう
サイン	サイン
有効	ゆうこう
女の人	おんなのひと
砕ける	くだける
何事	なにごと
弓	ゆみ
光栄	こうえい
バス	バス
リスク	リスク
ようこそ	ようこそ
押し寄せる	おしよせる
こむ	こむ
出番	でばん
皮膚	ひふ
二回	にかい
牛	うし
砕く	くだく
支援	しえん
湖	みずうみ
さも	さも
班	はん
別れ	わかれ
慕う	したう
めっちゃ	めっちゃ
進行	しんこう
番号	ばんごう
掛かる	かかる
人差し指	ひとさしゆび
済み	ずみ
持ち	もち
祭り	まつり
ハッと	ハッと
そのとおり	そのとおり
というところ	というところ
なにより	なにより
たちまち	たちまち
つづける	つづける
おやすみ	おやすみ
っこ	っこ
店	てん
種	たね
角度	かくど
振り払う	ふりはらう
三度	さんど
絶叫	ぜっきょう
課題	かだい
本番	ほんばん
温泉	おんせん
ライン	ライン
外部	がいぶ
子供の頃	こどものころ
言動	げんどう
向き	むき
坂	さか
知り合う	しりあう
崩れ落ちる	くずれおちる
ふりをする	ふりをする
せん	せん
胃	い
経緯	いきさつ
自室	じしつ
爆弾	ばくだん
見届ける	みとどける
とっとと	とっとと
馬鹿にする	ばかにする
こんな風に	こんなふうに
絆	きずな
豪華	ごうか
仕業	しわざ
硬直	こうちょく
病	やまい
高度	こうど
霊	れい
振り下ろす	ふりおろす
頼もしい	たのもしい
捜索	そうさく
意	い
好奇心	こうきしん
言い返す	いいかえす
戻って来る	もどってくる
未だに	いまだに
スープ	スープ
蘇る	よみがえる
お方	おかた
マンション	マンション
哀れ	あわれ
駆け出す	かけだす
別人	べつじん
博士	はかせ
派遣	はけん
咄嗟に	とっさに
あれこれ	あれこれ
トップ	トップ
弱る	よわる
掘る	ほる
身内	みうち
体内	たいない
独特	どくとく
励ます	はげます
反対側	はんたいがわ
体温	たいおん
お返し	おかえし
座り込む	すわりこむ
気楽	きらく
入院	にゅういん
運	うん
腰掛ける	こしかける
生意気	なまいき
ステージ	ステージ
美味い	うまい
寄り添う	よりそう
偉大	いだい
目つき	めつき
住民	じゅうみん
都	と
よいしょ	よいしょ
携帯電話	けいたいでんわ
コート	コート
風邪	かぜ
力を込める	ちからをこめる
あてる	あてる
狩り	かり
ことによって	ことによって
なんという	なんという
やつら	やつら
わがまま	わがまま
うつむく	うつむく
４人	よにん
なしで	なしで
うつ	うつ
うかがう	うかがう
かぎり	かぎり
今のうち	いまのうち
チッ	チッ
話し合い	はなしあい
振る舞う	ふるまう
うっすら	うっすら
向こう側	むこうがわ
さほど	さほど
心	しん
場	じょう
取り囲む	とりかこむ
観念	かんねん
登録	とうろく
スイッチ	スイッチ
殺人	さつじん
道路	どうろ
殺し	ころし
サービス	サービス
気を遣う	きをつかう
次々に	つぎつぎに
斜め	ななめ
懸命	けんめい
中庭	なかにわ
有利	ゆうり
夕飯	ゆうはん
探索	たんさく
刺さる	ささる
揉む	もむ
ぐるぐる	ぐるぐる
履く	はく
呪文	じゅもん
恐る恐る	おそるおそる
決まり	きまり
誕生	たんじょう
贅沢	ぜいたく
監督	かんとく
しょ	しょ
すっと	すっと
職員	しょくいん
釣る	つる
手間	てま
庇う	かばう
ポーズ	ポーズ
シーン	シーン
破れる	やぶれる
スタイル	スタイル
ふわふわ	ふわふわ
上位	じょうい
なんぞ	なんぞ
降り注ぐ	ふりそそぐ
色んな	いろんな
目を逸らす	めをそらす
新人	しんじん
気力	きりょく
赤ちゃん	あかちゃん
突撃	とつげき
死者	ししゃ
ペース	ペース
判明	はんめい
明かす	あかす
観る	みる
人目	ひとめ
証言	しょうげん
どころ	どころ
なあに	なあに
勢力	せいりょく
中学生	ちゅうがくせい
醜い	みにくい
蓋	ふた
思い浮かべる	おもいうかべる
制する	せいする
人格	じんかく
涙を流す	なみだをながす
まさしく	まさしく
兼ねる	かねる
からすれば	からすれば
曇る	くもる
上着	うわぎ
五分	ごぶ
中途半端	ちゅうとはんぱ
緊急	きんきゅう
決心	けっしん
念	ねん
検査	けんさ
運転	うんてん
解散	かいさん
不利	ふり
スペース	スペース
凝視	ぎょうし
何かと	なにかと
象徴	しょうちょう
支払う	しはらう
焦り	あせり
絶える	たえる
横から	よこから
かわす	かわす
いっしょに	いっしょに
迷惑をかける	めいわくをかける
あきらめる	あきらめる
１日	いちにち
よーし	よーし
というわけだ	というわけだ
まわり	まわり
いやらしい	いやらしい
よこす	よこす
嘘をつく	うそをつく
なんとかなる	なんとかなる
打ち合わせ	うちあわせ
一	ひと
no	data
公	こう
飛び降りる	とびおりる
顔を覗く	かおをのぞく
挑発	ちょうはつ
帰還	きかん
欠片	かけら
否	いいえ
コンビニ	コンビニ
秘める	ひめる
反射	はんしゃ
本部	ほんぶ
泥	どろ
化粧	けしょう
惚れる	ほれる
踏み出す	ふみだす
くぐる	くぐる
可哀想	かわいそう
目に遭う	めにあう
世話になる	せわになる
機嫌	きげん
分厚い	ぶあつい
無関係	むかんけい
昼休み	ひるやすみ
そんな中	そんななか
何一つ	なにひとつ
切ない	せつない
すらも	すらも
政治	せいじ
ダンス	ダンス
層	そう
警告	けいこく
着地	ちゃくち
旧	きゅう
アピール	アピール
満面	まんめん
嗅ぐ	かぐ
方角	ほうがく
息をつく	いきをつく
温度	おんど
投げ出す	なげだす
独り言	ひとりごと
悪夢	あくむ
位	くらい
傘	かさ
カレー	カレー
もう一回	もういっかい
苦しめる	くるしめる
ぽつり	ぽつり
異変	いへん
市民	しみん
在る	ある
陰	かげ
眼前	がんぜん
迎えに来る	むかえにくる
説	せつ
職	しょく
こする	こする
合格	ごうかく
クリア	クリア
敷地	しきち
限定	げんてい
喰う	くう
一角	いっかく
取り込む	とりこむ
思い返す	おもいかえす
じみる	じみる
お疲れ様	おつかれさま
力を入れる	ちからをいれる
意地	いじ
あるらしい	あるらしい
紫	むらさき
使命	しめい
追い込む	おいこむ
あからさま	あからさま
興味を持つ	きょうみをもつ
結婚式	けっこんしき
におい	におい
引き返す	ひきかえす
お断り	おことわり
ただただ	ただただ
わかりやすい	わかりやすい
こらえる	こらえる
かう	かう
もしや	もしや
いわば	いわば
やさしい	やさしい
まわる	まわる
ひく	ひく
いでる	いでる
あの方	あのかた
こととなる	こととなる
ばれる	ばれる
真っ暗	まっくら
うわー	うわー
どなた	どなた
多すぎる	おおすぎる
子たち	こたち
マズイ	マズイ
臭い	におい
お待たせしました	おまたせしました
熊	くま
放棄	ほうき
芝居	しばい
水面	すいめん
お別れ	おわかれ
無くなる	なくなる
群	ぐん
振り	ふり
損	そん
匂いがする	においがする
高速	こうそく
瓶	びん
お気に入り	おきにいり
吸収	きゅうしゅう
一個	いっこ
段	だん
憎い	にくい
進化	しんか
ふわり	ふわり
乱す	みだす
集合	しゅうごう
抜き	ぬき
息を吐く	いきをはく
煽る	あおる
油	あぶら
瞼	まぶた
混ざる	まざる
繰り出す	くりだす
年下	としした
初対面	しょたいめん
同僚	どうりょう
神社	じんじゃ
に限って	にかぎって
緊張感	きんちょうかん
敵意	てきい
墓	はか
前に進む	まえにすすむ
指揮	しき
解消	かいしょう
劣る	おとる
頭部	とうぶ
泡	あわ
潜る	もぐる
スタート	スタート
休日	きゅうじつ
持って行く	もっていく
涼しい	すずしい
頼り	たより
閉ざす	とざす
披露	ひろう
きょとん	きょとん
優しくする	やさしくする
卑怯	ひきょう
干渉	かんしょう
スタッフ	スタッフ
一階	いっかい
冒険	ぼうけん
親指	おやゆび
肘	ひじ
立ち尽くす	たちつくす
何事も	なにごとも
騒動	そうどう
切り出す	きりだす
起動	きどう
目当て	めあて
繊細	せんさい
なめる	なめる
パソコン	パソコン
衝突	しょうとつ
誰だって	だれだって
身を乗り出す	みをのりだす
打ち明ける	うちあける
自己	じこ
思惑	おもわく
そうかもしれない	そうかもしれない
対峙	たいじ
借金	しゃっきん
遺体	いたい
紐	ひも
惹く	ひく
同	どう
手続き	てつづき
すれ違う	すれちがう
くすぐったい	くすぐったい
ほとんどない	ほとんどない
とっさに	とっさに
こわい	こわい
上手くいく	うまくいく
お久しぶり	おひさしぶり
さらす	さらす
おばあちゃん	おばあちゃん
といわれる	といわれる
噴き出す	ふきだす
手がかり	てがかり
心当たり	こころあたり
面倒くさい	めんどうくさい
すばらしい	すばらしい
いたい	いたい
no	data
高	たか
概念	がいねん
に決まっている	にきまっている
日本語	にほんご
余	よ
潤む	うるむ
嘆く	なげく
力が抜ける	ちからがぬける
幼い頃	おさないころ
殺害	さつがい
招待	しょうたい
決着	けっちゃく
放り込む	ほうりこむ
振り上げる	ふりあげる
黄色い	きいろい
尾	お
お姫様	おひめさま
ペン	ペン
非	ひ
不安定	ふあんてい
カップル	カップル
快楽	かいらく
受け継ぐ	うけつぐ
撤退	てったい
相性	あいしょう
遭う	あう
一度だけ	いちどだけ
最期	さいご
スーツ	スーツ
なくても	なくても
決定的	けっていてき
要請	ようせい
配慮	はいりょ
員	いん
義理	ぎり
理論	りろん
ぶる	ぶる
まして	まして
物騒	ぶっそう
連れ出す	つれだす
一晩	ひとばん
ぎこちない	ぎこちない
鳴り響く	なりひびく
友情	ゆうじょう
ライバル	ライバル
緑色	みどりいろ
留守	るす
二度目	にどめ
如く	ごとく
さっと	さっと
見に来る	みにくる
ＯＫ	オッケー
アドバイス	アドバイス
冷蔵庫	れいぞうこ
優勝	ゆうしょう
気遣い	きづかい
不要	ふよう
青ざめる	あおざめる
章	しょう
現に	げんに
凍る	こおる
吹き飛ぶ	ふきとぶ
気にしないで	きにしないで
覚醒	かくせい
サポート	サポート
裂く	さく
止む	やむ
たった一人	たったひとり
着ける	つける
退く	しりぞく
本体	ほんたい
地点	ちてん
素振り	そぶり
きっぱり	きっぱり
大騒ぎ	おおさわぎ
存じる	ぞんじる
初日	しょにち
年頃	としごろ
持って来る	もってくる
独立	どくりつ
効率	こうりつ
陽	ひ
no	data
さる	さる
そこで	そこで
弱々しい	よわよわしい
やむ	やむ
投げつける	なげつける
絶対に	ぜったいに
死に	しに
考えてみれば	かんがえてみれば
いい感じ	いいかんじ
まとう	まとう
あるだけ	あるだけ
ケガ	ケガ
ご迷惑	ごめいわく
眉をひそめる	まゆをひそめる
こん	こん
なんというか	なんというか
物体	ぶったい
差し上げる	さしあげる
交流	こうりゅう
仕込む	しこむ
なぞる	なぞる
収穫	しゅうかく
直撃	ちょくげき
各地	かくち
拠点	きょてん
四つ	よっつ
アイドル	アイドル
急速	きゅうそく
キッチン	キッチン
欲	よく
最低限	さいていげん
へん	へん
久々	ひさびさ
国内	こくない
樹	き
無防備	むぼうび
兄妹	けいまい
浮気	うわき
すっきり	すっきり
眠り	ねむり
一行	いっこう
放送	ほうそう
花火	はなび
きゃあ	きゃあ
金額	きんがく
天気	てんき
浸る	ひたる
心地	ここち
プール	プール
店主	てんしゅ
無用	むよう
らか	らか
情熱	じょうねつ
瞬時	しゅんじ
歩み	あゆみ
洗濯	せんたく
毎回	まいかい
ジュース	ジュース
道理	どうり
元に戻る	もとにもどる
同級生	どうきゅうせい
相手をする	あいてをする
嫌がらせ	いやがらせ
うんざり	うんざり
結末	けつまつ
一刻も早く	いっこくもはやく
滞在	たいざい
ふらふら	ふらふら
通過	つうか
落ち着ける	おちつける
なんてこと	なんてこと
読み取る	よみとる
文	ぶん
であれ	であれ
紅	くれない
動機	どうき
一通り	ひととおり
末	すえ
特有	とくゆう
演奏	えんそう
後を追う	あとをおう
誘拐	ゆうかい
放り出す	ほうりだす
順番	じゅんばん
イケメン	イケメン
無礼	ぶれい
澄む	すむ
じゃう	じゃう
距離を取る	きょりをとる
何気ない	なにげない
信仰	しんこう
お土産	おみやげ
発射	はっしゃ
小娘	こむすめ
そうすると	そうすると
上半身	じょうはんしん
荒れる	あれる
リアル	リアル
滅びる	ほろびる
行方不明	ゆくえふめい
いくつ	いくつ
仕組み	しくみ
だれ	だれ
ハッキリ	ハッキリ
３日	みっか
どっちも	どっちも
向かい合う	むかいあう
２人とも	ふたりとも
なおさら	なおさら
ついていく	ついていく
しかたない	しかたない
目をやる	めをやる
あわてる	あわてる
かといって	かといって
良く	よく
後ろ姿	うしろすがた
弾	だん
位	い
愛しい	いとしい
リボン	リボン
片隅	かたすみ
大規模	だいきぼ
コントロール	コントロール
館	やかた
巨人	きょじん
よしよし	よしよし
この際	このさい
映す	うつす
ものとする	ものとする
悲劇	ひげき
見学	けんがく
整備	せいび
痛	つう
箇所	かしょ
席を立つ	せきをたつ
アパート	アパート
文字通り	もじどおり
全滅	ぜんめつ
不愉快	ふゆかい
鈴	すず
小僧	こぞう
取材	しゅざい
余る	あまる
乾杯	かんぱい
太る	ふとる
または	または
ありゃ	ありゃ
知恵	ちえ
習慣	しゅうかん
溺れる	おぼれる
耳を傾ける	みみをかたむける
ピンク	ピンク
次回	じかい
弾む	はずむ
長い間	ながいあいだ
パワー	パワー
申し訳ございません	もうしわけございません
観客	かんきゃく
一員	いちいん
引き起こす	ひきおこす
割と	わりと
阻止	そし
圧倒	あっとう
真相	しんそう
一家	いっか
ビール	ビール
外国	がいこく
情	じょう
一礼	いちれい
面々	めんめん
企画	きかく
何しろ	なにしろ
諸君	しょくん
来週	らいしゅう
やり直す	やりなおす
お部屋	おへや
お呼び	および
華やか	はなやか
企業	きぎょう
さえあれば	さえあれば
腹が立つ	はらがたつ
手入れ	ていれ
遊びに来る	あそびにくる
さようなら	さようなら
お祝い	おいわい
極端	きょくたん
一緒になる	いっしょになる
本に	ほんに
呼び止める	よびとめる
急激	きゅうげき
何百	なんびゃく
下半身	かはんしん
うるせえ	うるせえ
左腕	さわん
かなー	かなー
すう	すう
いくらなんでも	いくらなんでも
ろくに	ろくに
あな	あな
時間をかける	じかんをかける
かばう	かばう
ためらう	ためらう
もしかすると	もしかすると
こないだ	こないだ
いかなる	いかなる
打ち込む	うちこむ
バカにする	バカにする
キツい	キツい
ヶ月	かげつ
どのくらい	どのくらい
ところが	ところが
いささか	いささか
えーっと	えーっと
いやー	いやー
ほれ	ほれ
こんなふうに	こんなふうに
開ける	ひらける
十数	じゅうすう
強制	きょうせい
立ち向かう	たちむかう
機関	きかん
上等	じょうとう
迫力	はくりょく
箸	はし
託する	たくする
身構える	みがまえる
黙り込む	だまりこむ
開催	かいさい
物事	ものごと
に従い	にしたがい
製	せい
渦	うず
気にするな	きにするな
留める	とめる
馴染む	なじむ
突如	とつじょ
駆け抜ける	かけぬける
束	たば
両者	りょうしゃ
営業	えいぎょう
口を挟む	くちをはさむ
何だって	なんだって
尋常	じんじょう
どうにかなる	どうにかなる
脳内	のうない
くるり	くるり
絶句	ぜっく
辺	へん
痙攣	けいれん
神聖	しんせい
採用	さいよう
些細	ささい
とは限らない	とはかぎらない
考慮	こうりょ
駆る	かる
赤ん坊	あかんぼう
本質	ほんしつ
オーラ	オーラ
そういうことか	そういうことか
憎しみ	にくしみ
誘惑	ゆうわく
がっかり	がっかり
体格	たいかく
州	しゅう
一瞥	いちべつ
露骨	ろこつ
生地	きじ
擦る	する
人材	じんざい
運営	うんえい
何事か	なにごとか
出来	でき
着物	きもの
作り上げる	つくりあげる
歪める	ゆがめる
再	さい
結果的	けっかてき
獲得	かくとく
上回る	うわまわる
突進	とっしん
資金	しきん
降ろす	おろす
猿	さる
チャイム	チャイム
称する	しょうする
爽やか	さわやか
崖	がけ
正気	しょうき
くむ	くむ
くすぐる	くすぐる
癒す	いやす
生まれ	うまれ
へー	へー
見出す	みいだす
つき	つき
わざとらしい	わざとらしい
ってね	ってね
だます	だます
ましてや	ましてや
ぞう	ぞう
仕掛け	しかけ
割に	わりに
受付	うけつけ
のる	のる
膝をつく	ひざをつく
こと自体	ことじたい
からといって	からといって
しる	しる
当然のこと	とうぜんのこと
ていい	ていい
一つ一つ	ひとつひとつ
もむ	もむ
あわせる	あわせる
引きつる	ひきつる
そん	そん
しき	しき
印	しるし
センス	センス
耳に入る	みみにはいる
案の定	あんのじょう
悪化	あっか
数時間	すうじかん
繰り広げる	くりひろげる
気軽	きがる
目を輝かす	めをかがやかす
過程	かてい
泣き出す	なきだす
前髪	まえがみ
重み	おもみ
出してくれる	だしてくれる
武装	ぶそう
ほらほら	ほらほら
ニヤニヤ	ニヤニヤ
一層	いっそう
恥	はじ
肩を落とす	かたをおとす
たげる	たげる
よくする	よくする
語	ご
泉	いずみ
深める	ふかめる
通	つう
宗教	しゅうきょう
指示を出す	しじをだす
モード	モード
路地	ろじ
未知	みち
副	ふく
憎悪	ぞうお
傷口	きずぐち
力を貸す	ちからをかす
この場合	このばあい
思想	しそう
遊びに行く	あそびにいく
ストレス	ストレス
こういった	こういった
手加減	てかげん
勤める	つとめる
我ながら	われながら
前向き	まえむき
沈める	しずめる
抗う	あらがう
幕	まく
比較	ひかく
揺さぶる	ゆさぶる
傾ける	かたむける
広大	こうだい
無謀	むぼう
偽物	にせもの
顔を見せる	かおをみせる
痕跡	こんせき
殺意	さつい
一段	いちだん
賑やか	にぎやか
ベル	ベル
咳払い	せきばらい
青白い	あおじろい
代物	しろもの
教科書	きょうかしょ
っぷり	っぷり
宝	たから
であるから	であるから
巣	す
娘さん	むすめさん
密着	みっちゃく
浮かれる	うかれる
破滅	はめつ
上品	じょうひん
赴く	おもむく
転がす	ころがす
ヒント	ヒント
果て	はて
察知	さっち
跳ぶ	とぶ
広まる	ひろまる
奥様	おくさま
懸念	けねん
中断	ちゅうだん
単位	たんい
妨害	ぼうがい
犯罪者	はんざいしゃ
頼りない	たよりない
見返す	みかえす
砂糖	さとう
にやり	にやり
べつに	べつに
おのれ	おのれ
興味ない	きょうみない
あらかじめ	あらかじめ
何という	なんという
３つ	みっつ
おずおず	おずおず
片づける	かたづける
ごはん	ごはん
きゃっ	きゃっ
さりげない	さりげない
no	data
月	げつ
no	data
刹那	せつな
ついで	ついで
二百	にひゃく
手を貸す	てをかす
潜り込む	もぐりこむ
手術	しゅじゅつ
持ち帰る	もちかえる
ものですから	ものですから
生き延びる	いきのびる
むく	むく
早朝	そうちょう
揺らぐ	ゆらぐ
バッグ	バッグ
対面	たいめん
症状	しょうじょう
動画	どうが
毛布	もうふ
どんだけ	どんだけ
散らばる	ちらばる
市場	しじょう
聞き出す	ききだす
存分	ぞんぶん
レース	レース
微塵	みじん
現	げん
鼻を鳴らす	はなをならす
アニメ	アニメ
うっとり	うっとり
基礎	きそ
気を失う	きをうしなう
渦巻く	うずまく
週	しゅう
共	とも
濡らす	ぬらす
芯	しん
離婚	りこん
間抜け	まぬけ
番組	ばんぐみ
膨大	ぼうだい
聞き取る	ききとる
訪問	ほうもん
薄れる	うすれる
コップ	コップ
普段から	ふだんから
思い知る	おもいしる
誇らしい	ほこらしい
不自由	ふじゆう
数百	すうひゃく
飛び散る	とびちる
物言い	ものいい
居間	いま
殺気	さっき
不器用	ぶきよう
真	ま
衣服	いふく
翌朝	よくあさ
紳士	しんし
他国	たこく
駒	こま
泥棒	どろぼう
すかさず	すかさず
着せる	きせる
幹部	かんぶ
解説	かいせつ
彼方	かなた
突き刺す	つきさす
松	まつ
頂点	ちょうてん
思い浮かぶ	おもいうかぶ
美女	びじょ
ぐったり	ぐったり
港	みなと
食欲	しょくよく
圧力	あつりょく
失望	しつぼう
瞬き	まばたき
入手	にゅうしゅ
寺	じ
ぶつ	ぶつ
なんにも	なんにも
力ない	ちからない
問いかけ	といかけ
こんばんは	こんばんは
はめる	はめる
やらかす	やらかす
面持ち	おももち
わあっ	わあっ
さんざん	さんざん
はずない	はずない
落ち着き	おちつき
仲間たち	なかまたち
生まれてくる	うまれてくる
といえど	といえど
なにやら	なにやら
ええっと	ええっと
つか	つか
かざす	かざす
本	もと
no	data
類	たぐい
枠	わく
不在	ふざい
退治	たいじ
目を見る	めをみる
以後	いご
飛行機	ひこうき
よっしゃ	よっしゃ
サボる	サボる
震え	ふるえ
処刑	しょけい
愛らしい	あいらしい
血液	けつえき
送り込む	おくりこむ
縦	たて
科学	かがく
さよなら	さよなら
丸める	まるめる
後退	こうたい
戸惑い	とまどい
役に立てる	やくにたてる
ホール	ホール
関心	かんしん
防衛	ぼうえい
タイトル	タイトル
アップ	アップ
頼りになる	たよりになる
双方	そうほう
夢見る	ゆめみる
図る	はかる
区	く
ゆったり	ゆったり
来たる	きたる
その上で	そのうえで
試練	しれん
ぐう	ぐう
登校	とうこう
マーク	マーク
頂戴	ちょうだい
モテる	モテる
保存	ほぞん
的確	てきかく
帰り道	かえりみち
敵う	かなう
引き裂く	ひきさく
美貌	びぼう
給料	きゅうりょう
数分	すうふん
天国	てんごく
心強い	こころづよい
障害	しょうがい
祝う	いわう
かと思えば	かとおもえば
有する	ゆうする
まあね	まあね
破片	はへん
連携	れんけい
言われてみれば	いわれてみれば
涙目	なみだめ
割り込む	わりこむ
エンジン	エンジン
ずれる	ずれる
大して	たいして
絶望的	ぜつぼうてき
吐き捨てる	はきすてる
忠実	ちゅうじつ
拳を握る	こぶしをにぎる
垂らす	たらす
全体に	ぜんたいに
消耗	しょうもう
申し訳なさそう	もうしわけなさそう
予約	よやく
欲する	ほっする
消え去る	きえさる
湯気	ゆげ
湿る	しめる
ぽかん	ぽかん
頻繁	ひんぱん
独自	どくじ
ご褒美	ごほうび
くう	くう
祈り	いのり
引き継ぐ	ひきつぐ
外側	そとがわ
力が入る	ちからがはいる
思案	しあん
菓子	かし
かろうじて	かろうじて
くれぐれも	くれぐれも
驚くほど	おどろくほど
おめでとうございます	おめでとうございます
これまでに	これまでに
申し出	もうしで
それとも	それとも
もうひとつ	もうひとつ
１	いち
のせる	のせる
みるみる	みるみる
道	どう
両足	りょうあし
担う	になう
測る	はかる
一室	いっしつ
一般人	いっぱんじん
直感	ちょっかん
要は	ようは
縄	なわ
進路	しんろ
灰	はい
目を伏せる	めをふせる
常	つね
真顔	まがお
心得る	こころえる
豚	ぶた
ワイン	ワイン
コース	コース
強大	きょうだい
身を包む	みをつつむ
華	はな
唾	つば
午前中	ごぜんちゅう
駅前	えきまえ
修理	しゅうり
我が家	わがや
中国	ちゅうごく
ヒーロー	ヒーロー
頭を振る	かぶりをふる
気の毒	きのどく
正	せい
演出	えんしゅつ
対立	たいりつ
またしても	またしても
輩	やから
喫茶店	きっさてん
ささやか	ささやか
区別	くべつ
世代	せだい
じっと見る	じっとみる
飾り	かざり
声が出る	こえがでる
好き勝手	すきかって
連れて来る	つれてくる
他者	たしゃ
封筒	ふうとう
頑丈	がんじょう
メイン	メイン
険しい	けわしい
性能	せいのう
作成	さくせい
総	そう
断つ	たつ
何とかなる	なんとかなる
次元	じげん
たった今	たったいま
作家	さっか
充実	じゅうじつ
一連	いちれん
財産	ざいさん
回答	かいとう
改善	かいぜん
作	さく
懇願	こんがん
露出	ろしゅつ
無造作	むぞうさ
溶かす	とかす
張り切る	はりきる
即答	そくとう
阻む	はばむ
裏腹	うらはら
苛立ち	いらだち
予算	よさん
佇む	たたずむ
追い払う	おいはらう
お似合い	おにあい
手袋	てぶくろ
小型	こがた
主役	しゅやく
なんだかんだ	なんだかんだ
こめる	こめる
行き	いき
当たり	あたり
ご機嫌	ごきげん
からだ	からだ
すこし	すこし
引っ越す	ひっこす
もがく	もがく
カッコ	カッコ
お祭り	おまつり
ふたつ	ふたつ
もって	もって
つまむ	つまむ
さらう	さらう
見てもらう	みてもらう
成り立つ	なりたつ
no	data
たかが	たかが
気合い	きあい
それなら	それなら
頭	とう
子	し
島	とう
何だと	なんだと
図	ず
照明	しょうめい
握手	あくしゅ
敵対	てきたい
言葉を失う	ことばをうしなう
用がある	ようがある
企む	たくらむ
頭痛	ずつう
処置	しょち
目を通す	めをとおす
記念	きねん
物理的	ぶつりてき
たり	たり
明白	めいはく
反動	はんどう
やめておく	やめておく
温める	あたためる
詰め寄る	つめよる
院	いん
平凡	へいぼん
平穏	へいおん
中年	ちゅうねん
了承	りょうしょう
四方	しほう
小さい頃	ちいさいころ
私自身	わたしじしん
執着	しゅうちゃく
出来上がる	できあがる
装飾	そうしょく
踵を返す	きびすをかえす
道中	どうちゅう
身動き	みうごき
ぽん	ぽん
練る	ねる
のち	のち
通話	つうわ
不穏	ふおん
目を離す	めをはなす
一流	いちりゅう
拷問	ごうもん
歓喜	かんき
聞き返す	ききかえす
パートナー	パートナー
古代	こだい
リスト	リスト
青春	せいしゅん
販売	はんばい
さする	さする
前進	ぜんしん
盛る	もる
言語	げんご
羽織る	はおる
逆転	ぎゃくてん
初めから	はじめから
呼び方	よびかた
どうしたら	どうしたら
虎	とら
切り捨てる	きりすてる
に当たって	にあたって
厳重	げんじゅう
幸せにする	しあわせにする
埃	ほこり
宿題	しゅくだい
してみれば	してみれば
スーパー	スーパー
指名	しめい
縫う	ぬう
属する	ぞくする
刃物	はもの
原	はら
寿命	じゅみょう
まみれる	まみれる
これで	これで
にこやか	にこやか
どこにもない	どこにもない
ささやく	ささやく
いっつも	いっつも
１時間	いちじかん
どうでもよい	どうでもよい
吠える	ほえる
および	および
フランス	フランス
とめる	とめる
にすぎない	にすぎない
静かに	しずかに
ビックリ	ビックリ
引き続く	ひきつづく
ざわめき	ざわめき
つつく	つつく
有様	ありさま
折	おり
とてつもない	とてつもない
らも	らも
うらやましい	うらやましい
投げかける	なげかける
飛びつく	とびつく
辛い	からい
no	data
交代	こうたい
予想通り	よそうどおり
手助け	てだすけ
出	で
辿る	たどる
構え	かまえ
調べ	しらべ
鞭	むち
舞い上がる	まいあがる
空っぽ	からっぽ
十三	じゅうさん
富	とみ
黄色	きいろ
包丁	ほうちょう
囚われる	とらわれる
甲高い	かんだかい
ねえねえ	ねえねえ
粉	こな
どうかと思う	どうかとおもう
猛烈	もうれつ
設備	せつび
小刻み	こきざみ
だに	だに
感嘆	かんたん
呑む	のむ
痺れる	しびれる
強いる	しいる
物質	ぶっしつ
後頭部	こうとうぶ
シャワー	シャワー
待ち合わせ	まちあわせ
法律	ほうりつ
重	じゅう
吹き出す	ふきだす
提示	ていじ
社員	しゃいん
だらしない	だらしない
明後日	あさって
ぱっと	ぱっと
送り出す	おくりだす
十六	じゅうろく
曰く	いわく
前日	ぜんじつ
何日	なんにち
宝物	たからもの
救出	きゅうしゅつ
芸術	げいじゅつ
職場	しょくば
衣	ころも
住所	じゅうしょ
過剰	かじょう
汚れ	よごれ
日頃	ひごろ
すっ	すっ
球	きゅう
手を打つ	てをうつ
本棚	ほんだな
現実的	げんじつてき
形成	けいせい
自力	じりき
側から	そばから
例え	たとえ
ひっそり	ひっそり
さえすれば	さえすれば
倒れ込む	たおれこむ
重力	じゅうりょく
空を飛ぶ	そらをとぶ
浴びせる	あびせる
くらいなら	くらいなら
軌道	きどう
国境	こっきょう
ついさっき	ついさっき
一直線	いっちょくせん
権限	けんげん
募る	つのる
くるくる	くるくる
言うまでもない	いうまでもない
はやい	はやい
真っ黒	まっくろ
いってくる	いってくる
ニコニコ	ニコニコ
ご一緒	ごいっしょ
このくらい	このくらい
ノリ	ノリ
賭け	かけ
１週間	いっしゅうかん
たいした	たいした
はじめまして	はじめまして
語りかける	かたりかける
ご両親	ごりょうしん
あらあら	あらあら
そらす	そらす
ごらん	ごらん
おそらくは	おそらくは
ける	ける
思い当たる	おもいあたる
わが	わが
みっともない	みっともない
徹底	てってい
陰に	いんに
宮	みや
致命的	ちめいてき
修復	しゅうふく
稽古	けいこ
誤る	あやまる
流れ込む	ながれこむ
側面	そくめん
寝かせる	ねかせる
一緒にする	いっしょにする
ムカつく	ムカつく
見極める	みきわめる
仰向け	あおむけ
不敵	ふてき
修正	しゅうせい
恋をする	こいをする
棟	むね
見物	けんぶつ
紛れる	まぎれる
主義	しゅぎ
ゴール	ゴール
よくよく	よくよく
日曜日	にちようび
もどかしい	もどかしい
食器	しょっき
切	せつ
未熟	みじゅく
保管	ほかん
大通り	おおどおり
手作り	てづくり
恐縮	きょうしゅく
作用	さよう
と比べて	とくらべて
禁じる	きんじる
引退	いんたい
知らせ	しらせ
根性	こんじょう
枯れる	かれる
重たい	おもたい
一向に	いっこうに
高価	こうか
付け加える	つけくわえる
愚痴	ぐち
ずらす	ずらす
遠ざける	とおざける
切断	せつだん
統一	とういつ
標的	ひょうてき
大切な人	たいせつなひと
この方	このかた
妊娠	にんしん
流行	りゅうこう
初めまして	はじめまして
傲慢	ごうまん
臨む	のぞむ
六十	ろくじゅう
成す	なす
制止	せいし
行	こう
宿す	やどす
域	いき
にこにこ	にこにこ
ならともかく	ならともかく
言い分	いいぶん
ざっと	ざっと
家事	かじ
ミルク	ミルク
拗ねる	すねる
ぶつぶつ	ぶつぶつ
家具	かぐ
降り立つ	おりたつ
冷静になる	れいせいになる
恩	おん
視点	してん
鐘	かね
空ける	あける
誰にでも	だれにでも
他人事	ひとごと
代償	だいしょう
復帰	ふっき
豊富	ほうふ
麻痺	まひ
に応じて	におうじて
なおも	なおも
組み合わせ	くみあわせ
ありそう	ありそう
わりと	わりと
おしゃべり	おしゃべり
うずくまる	うずくまる
ご苦労	ごくろう
冷や汗	ひやあせ
どうにもならない	どうにもならない
すぐにでも	すぐにでも
われわれ	われわれ
ところでは	ところでは
向かい	むかい
おかえりなさい	おかえりなさい
控えめ	ひかえめ
ぎりぎり	ぎりぎり
教え	おしえ
上機嫌	じょうきげん
志	こころざし
今月	こんげつ
ニヤリ	ニヤリ
可憐	かれん
逃走	とうそう
自分の力	じぶんのちから
そりゃそうだ	そりゃそうだ
老	ろう
もとへ	もとへ
溜める	ためる
愕然	がくぜん
掻く	かく
多	た
密か	ひそか
事業	じぎょう
惜しむ	おしむ
果物	くだもの
に備えて	にそなえて
申し出る	もうしでる
飲み干す	のみほす
実戦	じっせん
偽	にせ
見下す	みくだす
異性	いせい
知らす	しらす
偽り	いつわり
ぐるりと	ぐるりと
パニック	パニック
とんだ	とんだ
ストレート	ストレート
音声	おんせい
よく見ると	よくみると
思い切り	おもいきり
振り切る	ふりきる
写る	うつる
反発	はんぱつ
学	がく
学年	がくねん
堪能	たんのう
からすると	からすると
生まれ変わる	うまれかわる
堂	どう
神妙	しんみょう
ドラマ	ドラマ
所有	しょゆう
取り返す	とりかえす
紡ぐ	つむぐ
一冊	いっさつ
商店街	しょうてんがい
裏側	うらがわ
率	りつ
書物	しょもつ
引き離す	ひきはなす
詰め込む	つめこむ
ビビる	ビビる
怪しむ	あやしむ
形式	けいしき
出向く	でむく
日記	にっき
狂気	きょうき
往復	おうふく
世紀	せいき
シーツ	シーツ
目の当たり	まのあたり
積み上げる	つみあげる
微笑ましい	ほほえましい
兼	けん
従業員	じゅうぎょういん
未練	みれん
計る	はかる
正常	せいじょう
真正面	ましょうめん
陽気	ようき
栄養	えいよう
意識を失う	いしきをうしなう
予備	よび
解き放つ	ときはなつ
絞り出す	しぼりだす
不意打ち	ふいうち
根本的	こんぽんてき
地区	ちく
はまる	はまる
いまいち	いまいち
それはない	それはない
手つき	てつき
ぴたり	ぴたり
お見舞い	おみまい
しみじみ	しみじみ
腰かける	こしかける
このあたり	このあたり
のぼる	のぼる
ともあれ	ともあれ
いたる	いたる
見つけ出す	みつけだす
それと	それと
笑いかける	わらいかける
じゃなきゃ	じゃなきゃ
始め	はじめ
所	しょ
小	こ
館	かん
説得力	せっとくりょく
境	さかい
保護者	ほごしゃ
杯	はい
この野郎	このやろう
犯行	はんこう
不良	ふりょう
回数	かいすう
足を運ぶ	あしをはこぶ
仲直り	なかなおり
通報	つうほう
ややこしい	ややこしい
拾い上げる	ひろいあげる
格	かく
工夫	くふう
驚かす	おどろかす
訂正	ていせい
納める	おさめる
生き返る	いきかえる
お楽しみ	おたのしみ
屈辱	くつじょく
一筋	ひとすじ
通り抜ける	とおりぬける
後者	こうしゃ
映し出す	うつしだす
その気になる	そのきになる
大嫌い	だいきらい
触れ合う	ふれあう
担ぐ	かつぐ
順番に	じゅんばんに
適切	てきせつ
延々	えんえん
軍隊	ぐんたい
火事	かじ
追及	ついきゅう
取り残す	とりのこす
却下	きゃっか
ふふん	ふふん
素	す
立て直す	たてなおす
末に	すえに
解体	かいたい
別々	べつべつ
断ち切る	たちきる
実在	じつざい
試しに	ためしに
知	ち
批判	ひはん
スプーン	スプーン
意を決する	いをけっする
籠	かご
最大限	さいだいげん
張り付く	はりつく
恥じる	はじる
三回	さんかい
埋め尽くす	うめつくす
堅い	かたい
真意	しんい
引っ込む	ひっこむ
守り	まもり
愛おしい	いとおしい
強制的	きょうせいてき
古	いにしえ
ついつい	ついつい
内臓	ないぞう
今となっては	いまとなっては
面会	めんかい
極める	きわめる
免れる	まぬがれる
幻想	げんそう
息苦しい	いきぐるしい
第四	だいよん
時間が経つ	じかんがたつ
アイデア	アイデア
冷やす	ひやす
お家	おうち
お目にかかる	おめにかかる
ってか	ってか
２回	にかい
アリ	アリ
あらためて	あらためて
パッと	パッと
せえ	せえ
おくる	おくる
いいわけ	いいわけ
それなのに	それなのに
わたる	わたる
まもない	まもない
都合のいい	つごうのいい
ぶん	ぶん
やっていく	やっていく
気まぐれ	きまぐれ
きっかけに	きっかけに
お守り	おまもり
出て来る	でてくる
みえる	みえる
ド	ド
二週間	にしゅうかん
青空	あおぞら
天然	てんねん
飛び上がる	とびあがる
オッケー	オッケー
甘やかす	あまやかす
絡める	からめる
越す	こす
後日	ごじつ
婦人	ふじん
吉	きち
当人	とうにん
信念	しんねん
待ち構える	まちかまえる
抱き寄せる	だきよせる
万全	ばんぜん
境遇	きょうぐう
業務	ぎょうむ
面倒を見る	めんどうをみる
ほっとく	ほっとく
押し倒す	おしたおす
黙々	もくもく
一目	ひとめ
改造	かいぞう
押さえつける	おさえつける
手遅れ	ておくれ
講義	こうぎ
どうだい	どうだい
放り投げる	ほうりなげる
土下座	どげざ
そら	そら
好きなだけ	すきなだけ
牛乳	ぎゅうにゅう
華奢	きゃしゃ
不吉	ふきつ
運転手	うんてんしゅ
ラッキー	ラッキー
真っ青	まっさお
三百	さんびゃく
そうですが	そうですが
風情	ふぜい
官	かん
詩	し
振り絞る	ふりしぼる
背の高い	せのたかい
紫色	むらさきいろ
立ち直る	たちなおる
フォーク	フォーク
継続	けいぞく
沼	ぬま
京都	きょうと
一分	いちぶ
所へ	ところへ
レストラン	レストラン
功績	こうせき
ざま	ざま
会釈	えしゃく
するべき	するべき
活用	かつよう
あったかい	あったかい
劇	げき
一夜	いちや
目元	めもと
受験	じゅけん
足場	あしば
誠実	せいじつ
文明	ぶんめい
合間	あいま
根元	ねもと
目前	もくぜん
静まり返る	しずまりかえる
暴く	あばく
旗	はた
仲良し	なかよし
滝	たき
画像	がぞう
銀行	ぎんこう
おす	おす
すがる	すがる
２	に
あいにく	あいにく
気にかける	きにかける
か月	かげつ
まだしも	まだしも
よくやった	よくやった
はじまる	はじまる
ごろ	ごろ
ふり	ふり
イライラ	イライラ
何度も	なんども
しきりに	しきりに
いつのまにか	いつのまにか
こめかみ	こめかみ
弾ける	はじける
りする	りする
行き先	いきさき
金持ち	かねもち
いまさら	いまさら
きょう	きょう
並	なみ
no	data
干す	ほす
伝言	でんごん
疑問に思う	ぎもんにおもう
縮める	ちぢめる
帯	おび
かの	かの
上目遣い	うわめづかい
プログラム	プログラム
クール	クール
井	い
公開	こうかい
貧乏	びんぼう
要望	ようぼう
その際	そのさい
苛立つ	いらだつ
制度	せいど
費用	ひよう
滅多に	めったに
脅かす	おびやかす
トラック	トラック
遂げる	とげる
相応	そうおう
皆無	かいむ
気取る	きどる
察し	さっし
弁護士	べんごし
足早	あしばや
対照的	たいしょうてき
十七	じゅうしち
価値観	かちかん
一秒	いちびょう
定期的	ていきてき
励む	はげむ
歩き回る	あるきまわる
半日	はんにち
日差し	ひざし
タクシー	タクシー
現地	げんち
集う	つどう
交える	まじえる
尊重	そんちょう
一帯	いったい
柵	さく
ほんのり	ほんのり
臆病	おくびょう
版	はん
地震	じしん
恐れ	おそれ
悪戯	いたずら
畳	たたみ
お詫び	おわび
絶対的	ぜったいてき
どうと	どうと
連	れん
でもって	でもって
戦略	せんりゃく
のみならず	のみならず
見て取る	みてとる
加工	かこう
ターゲット	ターゲット
豆	まめ
疑惑	ぎわく
鼻先	はなさき
リズム	リズム
研究所	けんきゅうじょ
何があっても	なにがあっても
小鳥	ことり
吹っ飛ぶ	ふっとぶ
くさい	くさい
街中	まちなか
質問をする	しつもんをする
出世	しゅっせ
十八	じゅうはち
とぼける	とぼける
高鳴る	たかなる
忍び込む	しのびこむ
局	きょく
甲	こう
汁	しる
見	み
冗談じゃない	じょうだんじゃない
追跡	ついせき
最善	さいぜん
よろめく	よろめく
贈り物	おくりもの
きらきら	きらきら
ポン	ポン
ご挨拶	ごあいさつ
ひっくり返す	ひっくりかえす
くっつける	くっつける
それこそ	それこそ
はく	はく
さながら	さながら
にあたって	にあたって
ほんとうに	ほんとうに
無理もない	むりもない
ねだる	ねだる
言うことを聞く	いうことをきく
まわす	まわす
車	しゃ
器	き
悪	わる
軽蔑	けいべつ
だけあって	だけあって
大物	おおもの
脇腹	わきばら
今晩	こんばん
雑談	ざつだん
言い残す	いいのこす
スケジュール	スケジュール
共にする	ともにする
当分	とうぶん
キャラクター	キャラクター
庶民	しょみん
コピー	コピー
散らす	ちらす
平静	へいせい
威嚇	いかく
手早い	てばやい
迎えに行く	むかえにいく
明ける	あける
すすめる	すすめる
気を抜く	きをぬく
無能	むのう
チーズ	チーズ
吹き込む	ふきこむ
濁る	にごる
見透かす	みすかす
走り去る	はしりさる
並み	なみ
乳	ちち
委員	いいん
建つ	たつ
皺	しわ
委員長	いいんちょう
仕入れる	しいれる
都会	とかい
従える	したがえる
食い込む	くいこむ
有無	うむ
何なのか	なんなのか
記者	きしゃ
構築	こうちく
宣伝	せんでん
参加者	さんかしゃ
当の	とうの
仮	かり
生産	せいさん
存在感	そんざいかん
願望	がんぼう
最	さい
五百	ごひゃく
と言うと	というと
対決	たいけつ
お辞儀	おじぎ
関わり	かかわり
快い	こころよい
京	きょう
やっつける	やっつける
引き下がる	ひきさがる
助言	じょげん
気が済む	きがすむ
万人	ばんにん
口々	くちぐち
食卓	しょくたく
旅立つ	たびだつ
分だけ	ぶんだけ
貢献	こうけん
とどまる	とどまる
天下	てんか
最新	さいしん
就職	しゅうしょく
大幅	おおはば
寝顔	ねがお
ドン	ドン
めんどくさい	めんどくさい
１枚	いちまい
わりに	わりに
見たところ	みたところ
たいてい	たいてい
湧き上がる	わきあがる
おやすみなさい	おやすみなさい
わけではありません	わけではありません
及び	および
抱きかかえる	だきかかえる
おもむろに	おもむろに
ときどき	ときどき
ひと言	ひとこと
おろす	おろす
もとより	もとより
まかせる	まかせる
くせ	くせ
タダ	タダ
２日	ふつか
しょう	しょう
子どもたち	こどもたち
つくづく	つくづく
１本	いっぽん
つくす	つくす
冊	さつ
取り乱す	とりみだす
今になって	いまになって
塀	へい
調達	ちょうたつ
不便	ふべん
無人	むじん
からして	からして
ってよ	ってよ
四年	よねん
肺	はい
病人	びょうにん
スポーツ	スポーツ
究極	きゅうきょく
支持	しじ
咎める	とがめる
読書	どくしょ
手を上げる	てをあげる
口実	こうじつ
原稿	げんこう
あしらう	あしらう
色気	いろけ
髪型	かみがた
少なくなる	すくなくなる
細工	さいく
留まる	とまる
のく	のく
体制	たいせい
行き来	ゆきき
礼儀	れいぎ
粒	つぶ
押し殺す	おしころす
空腹	くうふく
急ぎ	いそぎ
ピンチ	ピンチ
有能	ゆうのう
人口	じんこう
だったろう	だったろう
平等	びょうどう
そっぽを向く	そっぽをむく
得	とく
頭脳	ずのう
走り回る	はしりまわる
入れ替わる	いれかわる
不正	ふせい
眠気	ねむけ
ぞっと	ぞっと
軽やか	かろやか
どうせなら	どうせなら
貧しい	まずしい
に沿って	にそって
決する	けっする
何度でも	なんどでも
低下	ていか
身を隠す	みをかくす
手柄	てがら
言葉を交わす	ことばをかわす
幾	いく
ほい	ほい
取り組む	とりくむ
五日	いつか
横切る	よこぎる
違反	いはん
調理	ちょうり
侮辱	ぶじょく
経済	けいざい
重視	じゅうし
直し	なおし
裁判	さいばん
形相	ぎょうそう
代理	だいり
欲求	よっきゅう
平	ひら
網	あみ
コツ	コツ
牽制	けんせい
建設	けんせつ
出血	しゅっけつ
大気	たいき
割って入る	わってはいる
役者	やくしゃ
死人	しにん
睡眠	すいみん
不	ふ
拍子	ひょうし
寺	てら
いってらっしゃい	いってらっしゃい
たてる	たてる
まし	まし
とらえる	とらえる
おもちゃ	おもちゃ
ってな	ってな
にらむ	にらむ
すり抜ける	すりぬける
できるようになる	できるようになる
通りかかる	とおりかかる
めでたい	めでたい
２時	にじ
振る舞い	ふるまい
めがける	めがける
no	data
放出	ほうしゅつ
無理をする	むりをする
気恥ずかしい	きはずかしい
一瞬にして	いっしゅんにして
ストップ	ストップ
陸	りく
とく	とく
奪い取る	うばいとる
突き飛ばす	つきとばす
向上	こうじょう
先月	せんげつ
懐く	なつく
流行る	はやる
個室	こしつ
目を合わせる	めをあわせる
竹	たけ
威厳	いげん
欠かす	かかす
にわかに	にわかに
お顔	おかお
抱き上げる	だきあげる
立ちはだかる	たちはだかる
自動	じどう
共感	きょうかん
核	かく
すんなり	すんなり
率直	そっちょく
仕切る	しきる
心境	しんきょう
承諾	しょうだく
ちょい	ちょい
離脱	りだつ
入	いり
右側	みぎがわ
段々	だんだん
報告書	ほうこくしょ
自動車	じどうしゃ
人殺し	ひとごろし
二重	にじゅう
植える	うえる
丈	たけ
逃亡	とうぼう
落胆	らくたん
足跡	あしあと
対等	たいとう
学者	がくしゃ
野球	やきゅう
メリット	メリット
ベスト	ベスト
立ち寄る	たちよる
取り付ける	とりつける
抱き合う	だきあう
数学	すうがく
精	せい
毎朝	まいあさ
自業自得	じごうじとく
切り離す	きりはなす
至るまで	いたるまで
無理はない	むりはない
投入	とうにゅう
漠然	ばくぜん
心細い	こころぼそい
代々	だいだい
反する	はんする
突っ立つ	つったつ
もう少しで	もうすこしで
しっ	しっ
罵る	ののしる
取り繕う	とりつくろう
侮る	あなどる
巻	かん
利	り
鹿	しか
滑らか	なめらか
わく	わく
日が暮れる	ひがくれる
破裂	はれつ
気を使う	きをつかう
活かす	いかす
幹	みき
しばらくの間	しばらくのあいだ
出くわす	でくわす
うける	うける
これこそ	これこそ
日付	ひづけ
なるだけ	なるだけ
あのよう	あのよう
ろくな	ろくな
ことごとく	ことごとく
決めつける	きめつける
もる	もる
をもって	をもって
釣り	つり
なおす	なおす
見せかける	みせかける
山ほど	やまほど
意味ない	いみない
すさまじい	すさまじい
なんと	なんと
no	data
イギリス	イギリス
手際	てぎわ
埋もれる	うもれる
滑稽	こっけい
引っ張り出す	ひっぱりだす
１０分	じっぷん
同感	どうかん
はにかむ	はにかむ
ここら	ここら
どうかしら	どうかしら
行使	こうし
各々	おのおの
動き回る	うごきまわる
茶色	ちゃいろ
二枚	にまい
交互	こうご
本名	ほんみょう
ペット	ペット
業者	ぎょうしゃ
押し当てる	おしあてる
流し込む	ながしこむ
専門家	せんもんか
亡くす	なくす
小走り	こばしり
気を取り直す	きをとりなおす
逃げ込む	にげこむ
各国	かっこく
べきではない	べきではない
同志	どうし
手の甲	てのこう
さらり	さらり
忘れ物	わすれもの
しょっちゅう	しょっちゅう
情報収集	じょうほうしゅうしゅう
説く	とく
裏切り	うらぎり
頼りにする	たよりにする
少なからず	すくなからず
形状	けいじょう
頼むから	たのむから
プレッシャー	プレッシャー
ひらひら	ひらひら
即	そく
押し出す	おしだす
必ずしも	かならずしも
進展	しんてん
頑固	がんこ
性別	せいべつ
責任者	せきにんしゃ
自嘲	じちょう
割り切る	わりきる
見計らう	みはからう
比	ひ
失格	しっかく
と考えられる	とかんがえられる
態勢	たいせい
動じる	どうじる
裂ける	さける
ライト	ライト
パス	パス
ハート	ハート
テーマ	テーマ
儚い	はかない
今こそ	いまこそ
真理	しんり
手を回す	てをまわす
鮮明	せんめい
果てる	はてる
売り	うり
毎晩	まいばん
連想	れんそう
伝統	でんとう
洋服	ようふく
狼狽	ろうばい
最適	さいてき
お約束	おやくそく
光を放つ	ひかりをはなつ
米	こめ
難い	にくい
科	か
ぶちまける	ぶちまける
夜明け	よあけ
さらなる	さらなる
たいへん	たいへん
うろつく	うろつく
紛れもない	まぎれもない
にじむ	にじむ
あーあ	あーあ
なだめる	なだめる
ヨーロッパ	ヨーロッパ
につき	につき
なでる	なでる
火をつける	ひをつける
とくに	とくに
つかまる	つかまる
目をそらす	めをそらす
年寄り	としより
さまよう	さまよう
しいる	しいる
留まる	とどまる
取り除く	とりのぞく
使いこなす	つかいこなす
先週	せんしゅう
そうでなければ	そうでなければ
長男	ちょうなん
悲痛	ひつう
由来	ゆらい
客観的	きゃっかんてき
置き去り	おきざり
弄ぶ	もてあそぶ
緩い	ゆるい
背中を押す	せなかをおす
進歩	しんぽ
乏しい	とぼしい
許し	ゆるし
住まう	すまう
元に戻す	もとにもどす
久しい	ひさしい
済ます	すます
に加え	にくわえ
順に	じゅんに
敬語	けいご
怠る	おこたる
寒気	さむけ
十一	じゅういち
お帰りなさい	おかえりなさい
誓い	ちかい
感染	かんせん
不可解	ふかかい
輪郭	りんかく
夕日	ゆうひ
十日	とおか
欠点	けってん
ざわつく	ざわつく
どうしたものか	どうしたものか
雑	ざつ
公式	こうしき
口に運ぶ	くちにはこぶ
費やす	ついやす
予言	よげん
覆す	くつがえす
表紙	ひょうし
開放	かいほう
渋々	しぶしぶ
要する	ようする
気温	きおん
初め	はじめ
透ける	すける
設計	せっけい
信号	しんごう
また今度	またこんど
度胸	どきょう
打撃	だげき
専念	せんねん
ぬるい	ぬるい
数日後	すうじつご
窮屈	きゅうくつ
時間帯	じかんたい
お願いだから	おねがいだから
正反対	せいはんたい
嫌悪	けんお
用心	ようじん
河	かわ
個性	こせい
本題	ほんだい
面影	おもかげ
最優先	さいゆうせん
待ち受ける	まちうける
駆け込む	かけこむ
体質	たいしつ
申請	しんせい
よさそう	よさそう
痩せる	やせる
武	ぶ
お迎え	おむかえ
負傷	ふしょう
表向き	おもてむき
一変	いっぺん
長引く	ながびく
医療	いりょう
摘む	つむ
替える	かえる
あくび	あくび
集まり	あつまり
生まれて初めて	うまれてはじめて
べし	べし
根本	こんぽん
くつろぐ	くつろぐ
すする	すする
おうち	おうち
いっそう	いっそう
ある時	あるとき
痛っ	いたっ
ドイツ	ドイツ
おろか	おろか
あわ	あわ
めぐる	めぐる
うろたえる	うろたえる
しばしば	しばしば
角	かく
大金	たいきん
わくわく	わくわく
直る	なおる
成る	なる
特性	とくせい
火花	ひばな
考え事	かんがえごと
実績	じっせき
知性	ちせい
早口	はやくち
介入	かいにゅう
人種	じんしゅ
濃厚	のうこう
推薦	すいせん
必死になって	ひっしになって
引き連れる	ひきつれる
丈夫	じょうぶ
飢える	うえる
名付ける	なづける
その気	そのき
マイナス	マイナス
お時間	おじかん
ピンク色	ピンクいろ
筆	ふで
追放	ついほう
授ける	さずける
透き通る	すきとおる
プラス	プラス
発達	はったつ
話し始める	はなしはじめる
読者	どくしゃ
びる	びる
コメント	コメント
留守番	るすばん
無縁	むえん
分野	ぶんや
本性	ほんしょう
そわそわ	そわそわ
鈍る	にぶる
感激	かんげき
見比べる	みくらべる
徹夜	てつや
右足	みぎあし
権	けん
至極	しごく
最後の最後	さいごのさいご
苦戦	くせん
独占	どくせん
繰り返し	くりかえし
成し遂げる	なしとげる
初期	しょき
絶妙	ぜつみょう
一滴	いってき
突き止める	つきとめる
ちらちら	ちらちら
左側	ひだりがわ
一環	いっかん
正す	ただす
連絡を取る	れんらくをとる
とうに	とうに
十四	じゅうし
無責任	むせきにん
人員	じんいん
手を組む	てをくむ
三本	さんぼん
手順	てじゅん
意味不明	いみふめい
補う	おぎなう
遠目	とおめ
養う	やしなう
悪口	わるぐち
惨め	みじめ
キレる	キレる
見て回る	みてまわる
場合によって	ばあいによって
二十歳	はたち
揺する	ゆする
迎え入れる	むかえいれる
命を落とす	いのちをおとす
朝日	あさひ
こうなると	こうなると
ちゃう	ちゃう
源	みなもと
ばい	ばい
わり	わり
口ぶり	くちぶり
良くなる	よくなる
ガス	ガス
つぶす	つぶす
積もる	つもる
やかましい	やかましい
歯を食いしばる	はをくいしばる
下に	しもに
引き出し	ひきだし
おかわり	おかわり
そんなわけで	そんなわけで
あきれる	あきれる
ほんとう	ほんとう
よって	よって
前	ぜん
空	から
平均	へいきん
引き戻す	ひきもどす
首都	しゅと
揺れ	ゆれ
人手	ひとで
ばっちり	ばっちり
工事	こうじ
どうしたって	どうしたって
一月	いちがつ
早	はや
五つ	いつつ
アルバイト	アルバイト
軽々	かるがる
予想以上	よそういじょう
じわじわ	じわじわ
期	き
団体	だんたい
上では	うえでは
大臣	だいじん
襟	えり
永久	えいきゅう
脅迫	きょうはく
何でもいい	なんでもいい
仲が良い	なかがよい
出場	しゅつじょう
潮	しお
連れ去る	つれさる
造り	つくり
収入	しゅうにゅう
退ける	しりぞける
音もなく	おともなく
沢	さわ
途絶える	とだえる
座席	ざせき
憂鬱	ゆううつ
呼び寄せる	よびよせる
行事	ぎょうじ
見習う	みならう
土曜日	どようび
限りない	かぎりない
嘲笑	ちょうしょう
果実	かじつ
タイム	タイム
持ち合わせる	もちあわせる
余韻	よいん
務め	つとめ
全体的	ぜんたいてき
快適	かいてき
数多く	かずおおく
緩やか	ゆるやか
敗れる	やぶれる
一心	いっしん
成人	せいじん
お付き合い	おつきあい
委員会	いいんかい
相違	そうい
一昨日	おととい
昭和	しょうわ
当事者	とうじしゃ
たか	たか
とことん	とことん
楽器	がっき
交際	こうさい
勝	しょう
尊い	とうとい
身を守る	みをまもる
変わりない	かわりない
過酷	かこく
バタバタ	バタバタ
絵画	かいが
引っ込める	ひっこめる
正当	せいとう
熱気	ねっき
包み	つつみ
確証	かくしょう
経由	けいゆ
一転	いってん
に加えて	にくわえて
全開	ぜんかい
突き進む	つきすすむ
嫌味	いやみ
手出し	てだし
いたずら	いたずら
さぞ	さぞ
でっかい	でっかい
うなだれる	うなだれる
まね	まね
いいかげん	いいかげん
遅く	おそく
さらさら	さらさら
ワクワク	ワクワク
一人一人	ひとりひとり
たりとも	たりとも
たどる	たどる
かむ	かむ
やしない	やしない
おごる	おごる
慌ただしい	あわただしい
開く	あく
堪える	たえる
公	おおやけ
血管	けっかん
追求	ついきゅう
賛同	さんどう
秩序	ちつじょ
要因	よういん
自称	じしょう
大学生	だいがくせい
償う	つぐなう
デザート	デザート
聞き覚え	ききおぼえ
嫌になる	いやになる
救急車	きゅうきゅうしゃ
デビュー	デビュー
強気	つよき
悪人	あくにん
通称	つうしょう
拝む	おがむ
屈する	くっする
各自	かくじ
夫妻	ふさい
離れ	はなれ
彩る	いろどる
供給	きょうきゅう
増加	ぞうか
真摯	しんし
聞き流す	ききながす
車内	しゃない
先祖	せんぞ
カバー	カバー
必然	ひつぜん
手を差し伸べる	てをさしのべる
岡	おか
投げ捨てる	なげすてる
ごっこ	ごっこ
無念	むねん
男らしい	おとこらしい
検索	けんさく
妥当	だとう
据える	すえる
解析	かいせき
失態	しったい
制作	せいさく
覚める	さめる
昼寝	ひるね
強	きょう
華麗	かれい
無難	ぶなん
ふらつく	ふらつく
書き込む	かきこむ
しゃがむ	しゃがむ
莫大	ばくだい
没頭	ぼっとう
口走る	くちばしる
腹立たしい	はらだたしい
彼自身	かれじしん
徒歩	とほ
仕上げる	しあげる
政治家	せいじか
見過ごす	みすごす
質問に答える	しつもんにこたえる
実践	じっせん
来月	らいげつ
悲惨	ひさん
耳打ち	みみうち
大阪	おおさか
翻弄	ほんろう
通り越す	とおりこす
帰国	きこく
手応え	てごたえ
手招き	てまねき
深まる	ふかまる
海岸	かいがん
反抗	はんこう
ホーム	ホーム
見込む	みこむ
組み合わせる	くみあわせる
素性	すじょう
面する	めんする
業	ぎょう
かえる	かえる
あり得る	ありうる
まんま	まんま
おつもり	おつもり
分かりやすい	わかりやすい
できる限り	できるかぎり
ひそか	ひそか
手当て	てあて
しでかす	しでかす
たまえ	たまえ
見込み	みこみ
くわえる	くわえる
きたる	きたる
とまる	とまる
ところどころ	ところどころ
方がよい	ほうがよい
いいって言う	いいっていう
大きめ	おおきめ
no	data
真に	まことに
まれ	まれ
時間の問題	じかんのもんだい
この頃	このごろ
一息	ひといき
お世話	おせわ
毎日のように	まいにちのように
補充	ほじゅう
嗚咽	おえつ
来	らい
諭す	さとす
甲斐	かい
敬意	けいい
津	つ
疑念	ぎねん
七十	しちじゅう
善	ぜん
沸く	わく
階級	かいきゅう
合計	ごうけい
数少ない	かずすくない
問い詰める	といつめる
同等	どうとう
闘う	たたかう
観光	かんこう
世界一	せかいいち
奥深い	おくふかい
節	ふし
踊り	おどり
学問	がくもん
生活を送る	せいかつをおくる
抜群	ばつぐん
距離を置く	きょりをおく
下品	げひん
危険性	きけんせい
細長い	ほそながい
定番	ていばん
痕	あと
演説	えんぜつ
指し示す	さししめす
プラン	プラン
四日	よっか
和	わ
退院	たいいん
耳を澄ます	みみをすます
奉仕	ほうし
明らかになる	あきらかになる
出歩く	であるく
コーナー	コーナー
年後	ねんご
更新	こうしん
渋い	しぶい
法則	ほうそく
サイト	サイト
圧迫	あっぱく
足首	あしくび
同い年	おないどし
お風呂に入る	おふろにはいる
束ねる	たばねる
先行	せんこう
じりじり	じりじり
大層	たいそう
見舞う	みまう
執拗	しつよう
補助	ほじょ
後回し	あとまわし
警戒心	けいかいしん
近頃	ちかごろ
息をする	いきをする
匹敵	ひってき
意図的	いとてき
現金	げんきん
労働	ろうどう
浜	はま
抱え込む	かかえこむ
効果的	こうかてき
スムーズ	スムーズ
驚くべき	おどろくべき
持ち歩く	もちあるく
居心地	いごこち
断じて	だんじて
軒	けん
稀	まれ
言葉をかける	ことばをかける
押しかける	おしかける
まぶしい	まぶしい
はなれる	はなれる
なびく	なびく
うまくやる	うまくやる
大きすぎる	おおきすぎる
ひねる	ひねる
立ち上る	たちのぼる
かすめる	かすめる
ざわめく	ざわめく
どん	どん
悔やむ	くやむ
正直なところ	しょうじきなところ
呼びかけ	よびかけ
踏みつける	ふみつける
表	ひょう
その度	そのたび
形態	けいたい
カット	カット
名目	めいもく
学習	がくしゅう
競争	きょうそう
有力	ゆうりょく
口に入る	くちにはいる
頭に浮かぶ	あたまにうかぶ
速やか	すみやか
視察	しさつ
物語る	ものがたる
プライベート	プライベート
往来	おうらい
隔てる	へだてる
弱気	よわき
それ以来	それいらい
巧み	たくみ
観測	かんそく
周	しゅう
こそこそ	こそこそ
窓際	まどぎわ
だけしか	だけしか
前半	ぜんはん
報う	むくう
目で追う	めでおう
拝見	はいけん
応用	おうよう
見当	けんとう
現時点	げんじてん
長時間	ちょうじかん
考え直す	かんがえなおす
借り	かり
関節	かんせつ
血を流す	ちをながす
死後	しご
週末	しゅうまつ
言ったって	いったって
人前で	ひとまえで
しばらくすると	しばらくすると
腕前	うでまえ
休息	きゅうそく
製造	せいぞう
追いやる	おいやる
乗り切る	のりきる
それ自体	それじたい
集中力	しゅうちゅうりょく
募集	ぼしゅう
リラックス	リラックス
絶好	ぜっこう
勝る	まさる
論	ろん
不服	ふふく
一日中	いちにちじゅう
百年	ひゃくねん
何時	なんじ
検証	けんしょう
現役	げんえき
警察官	けいさつかん
心なしか	こころなしか
豪快	ごうかい
葛藤	かっとう
因縁	いんねん
苦悩	くのう
花が咲く	はながさく
心情	しんじょう
容疑者	ようぎしゃ
身勝手	みがって
自在	じざい
見受ける	みうける
正気	せいき
休暇	きゅうか
必須	ひっす
治安	ちあん
祝い	いわい
失せる	うせる
寝床	ねどこ
好きなように	すきなように
らな	らな
さんか	さんか
のむ	のむ
年月	としつき
寝ぼける	ねぼける
眠りにつく	ねむりにつく
ありとあらゆる	ありとあらゆる
のめる	のめる
がん	がん
ご案内	ごあんない
気がつくと	きがつくと
ちっちゃい	ちっちゃい
どういたしまして	どういたしまして
よみがえる	よみがえる
成り行き	なりゆき
ずーっと	ずーっと
おくれる	おくれる
食いつく	くいつく
ほのか	ほのか
押しのける	おしのける
電話をかける	でんわをかける
no	data
反響	はんきょう
一台	いちだい
に取って	にとって
健全	けんぜん
お越し	おこし
弱	じゃく
詐欺	さぎ
人通り	ひとどおり
すねる	すねる
好都合	こうつごう
笑い出す	わらいだす
高貴	こうき
賞	しょう
広める	ひろめる
見合う	みあう
権威	けんい
降参	こうさん
知人	ちじん
定義	ていぎ
お知らせ	おしらせ
早急	そうきゅう
半端	はんぱ
高らか	たからか
遮断	しゃだん
おやおや	おやおや
報道	ほうどう
意向	いこう
待ち	まち
召し上がる	めしあがる
揺る	ゆる
思い描く	おもいえがく
自信満々	じしんまんまん
群がる	むらがる
革命	かくめい
生存	せいぞん
呼ばわり	よばわり
あとから	あとから
好ましい	このましい
拍子抜け	ひょうしぬけ
行列	ぎょうれつ
無料	むりょう
日曜	にちよう
に反して	にはんして
支障	ししょう
芽生える	めばえる
犠牲者	ぎせいしゃ
大小	だいしょう
凝る	こる
でよ	でよ
自分勝手	じぶんかって
動向	どうこう
明らかにする	あきらかにする
週間	しゅうかん
暁	あかつき
片付く	かたづく
気安い	きやすい
害	がい
孤立	こりつ
探し出す	さがしだす
お連れ	おつれ
公表	こうひょう
逃げ場	にげば
背伸び	せのび
本能的	ほんのうてき
万能	ばんのう
ゆらゆら	ゆらゆら
犠牲になる	ぎせいになる
積み重ねる	つみかさねる
品物	しなもの
疑わしい	うたがわしい
朝早く	あさはやく
くっきり	くっきり
いたって	いたって
リード	リード
一人前	いちにんまえ
研究者	けんきゅうしゃ
初耳	はつみみ
社会的	しゃかいてき
涙が出る	なみだがでる
蓄積	ちくせき
外国人	がいこくじん
仕事中	しごとちゅう
直	じき
いつにない	いつにない
つながり	つながり
ちと	ちと
荒らす	あらす
目をつける	めをつける
ひっくり返る	ひっくりかえる
良いこと	よいこと
お供	おとも
すぐそば	すぐそば
あっけない	あっけない
までも	までも
つかう	つかう
引き込む	ひきこむ
決着をつける	けっちゃくをつける
長いこと	ながいこと
いやがる	いやがる
no	data
no	data
云々	うんぬん
作者	さくしゃ
手を入れる	てをいれる
猶予	ゆうよ
荒々しい	あらあらしい
元通り	もとどおり
白状	はくじょう
生々しい	なまなましい
飛び交う	とびかう
所持	しょじ
援助	えんじょ
断定	だんてい
差別	さべつ
事項	じこう
第三者	だいさんしゃ
欠く	かく
選挙	せんきょ
沿い	ぞい
律儀	りちぎ
計	けい
危	き
中心とする	ちゅうしんとする
アウト	アウト
成分	せいぶん
有名人	ゆうめいじん
極力	きょくりょく
心理	しんり
惑わす	まどわす
囲う	かこう
人間関係	にんげんかんけい
採る	とる
慰め	なぐさめ
すっぽり	すっぽり
おさまる	おさまる
切り上げる	きりあげる
主な	おもな
恩人	おんじん
思い知らす	おもいしらす
建築	けんちく
隠し事	かくしごと
話題になる	わだいになる
畳む	たたむ
出張	しゅっちょう
ずる	ずる
駆使	くし
連なる	つらなる
読み	よみ
後ろめたい	うしろめたい
独身	どくしん
痛々しい	いたいたしい
住居	じゅうきょ
うろうろ	うろうろ
水分	すいぶん
短時間	たんじかん
焦点	しょうてん
原理	げんり
仮定	かてい
放題	ほうだい
衰える	おとろえる
延長	えんちょう
切り取る	きりとる
突き放す	つきはなす
せねば	せねば
しなやか	しなやか
言い合う	いいあう
身を引く	みをひく
当	とう
割合	わりあい
手を合わせる	てをあわせる
破棄	はき
来客	らいきゃく
両側	りょうがわ
記述	きじゅつ
見解	けんかい
合	ごう
席に着く	せきにつく
初めは	はじめは
罵倒	ばとう
を回って	をめぐって
適する	てきする
仲がいい	なかがいい
持ちかける	もちかける
ごちそうさま	ごちそうさま
死ぬほど	しぬほど
お出かけ	おでかけ
ためになる	ためになる
まことに	まことに
いいかい	いいかい
第１	だいいち
かじる	かじる
のしかかる	のしかかる
立ち入る	たちいる
聞きつける	ききつける
お使い	おつかい
はる	はる
そうかい	そうかい
取り巻く	とりまく
納得がいく	なっとくがいく
入る	いる
的	まと
no	data
笑	わら
しんどい	しんどい
関与	かんよ
謙遜	けんそん
当面	とうめん
ぐっすり	ぐっすり
足す	たす
交わる	まじわる
案じる	あんじる
寝不足	ねぶそく
看病	かんびょう
自動的	じどうてき
危機感	ききかん
間柄	あいだがら
偽る	いつわる
すべ	すべ
分類	ぶんるい
特権	とっけん
委ねる	ゆだねる
規則	きそく
岸	きし
定まる	さだまる
推す	おす
連れ戻す	つれもどす
少数	しょうすう
生前	せいぜん
寝起き	ねおき
次から次へと	つぎからつぎへと
開き直る	ひらきなおる
恩恵	おんけい
返し	かえし
焦げる	こげる
空になる	からになる
付き添う	つきそう
支え	ささえ
規定	きてい
競う	きそう
どっと	どっと
過ち	あやまち
引き換え	ひきかえ
そそくさ	そそくさ
格闘	かくとう
つかまえる	つかまえる
思いがけない	おもいがけない
脅し	おどし
異論	いろん
記載	きさい
清潔	せいけつ
占領	せんりょう
ポジション	ポジション
勤務	きんむ
晴らす	はらす
大部分	だいぶぶん
損ねる	そこねる
うんと	うんと
徹する	てっする
就く	つく
正真正銘	しょうしんしょうめい
こだわり	こだわり
予告	よこく
重苦しい	おもくるしい
鼻歌	はなうた
がかる	がかる
見入る	みいる
著しい	いちじるしい
北海道	ほっかいどう
頂上	ちょうじょう
踏まえる	ふまえる
力を合わせる	ちからをあわせる
入れ替える	いれかえる
臨時	りんじ
直接的	ちょくせつてき
見とれる	みとれる
強がる	つよがる
かりる	かりる
たくましい	たくましい
よりによって	よりによって
とぶ	とぶ
どちらかというと	どちらかというと
ちょうどよい	ちょうどよい
ロシア	ロシア
のんき	のんき
しかける	しかける
そのうちに	そのうちに
はな	はな
あげく	あげく
せいにする	せいにする
がかり	がかり
no	data
をおいて	をおいて
打ち消す	うちけす
ゆる	ゆる
すくう	すくう
仕方のない	しかたのない
申し込む	もうしこむ
一息つく	ひといきつく
汗をかく	あせをかく
家	や
色	しょく
no	data
葬る	ほうむる
物足りない	ものたりない
気を取られる	きをとられる
この通り	このとおり
憂い	うれい
影響力	えいきょうりょく
顔見知り	かおみしり
強固	きょうこ
ついて来る	ついてくる
お伺い	おうかがい
背が高い	せがたかい
年代	ねんだい
参考	さんこう
口を出す	くちをだす
閉鎖	へいさ
認定	にんてい
公平	こうへい
やり過ごす	やりすごす
政治的	せいじてき
アルコール	アルコール
明	めい
写真を撮る	しゃしんをとる
項目	こうもく
年生	ねんせい
図星	ずぼし
活気	かっき
辛抱	しんぼう
見破る	みやぶる
潔い	いさぎよい
細か	こまか
今週	こんしゅう
事柄	ことがら
迅速	じんそく
代金	だいきん
価格	かかく
無性に	むしょうに
連れ込む	つれこむ
直ちに	ただちに
言葉遣い	ことばづかい
盛ん	さかん
単独	たんどく
合理的	ごうりてき
判定	はんてい
人より	ひとより
旨	むね
詮索	せんさく
念を押す	ねんをおす
片っ端から	かたっぱしから
妥協	だきょう
溶け込む	とけこむ
所在	しょざい
数年前	すうねんまえ
安易	あんい
遂行	すいこう
汲む	くむ
電源	でんげん
店舗	てんぽ
責任を取る	せきにんをとる
持て余す	もてあます
かん	かん
安	やす
食い止める	くいとめる
生死	せいし
恋しい	こいしい
素質	そしつ
育ち	そだち
市内	しない
延びる	のびる
甲斐がある	かいがある
溝	みぞ
誠意	せいい
言い張る	いいはる
克服	こくふく
つむ	つむ
ある種	あるしゅ
休める	やすめる
にわたって	にわたって
くら	くら
ほかにも	ほかにも
あたかも	あたかも
近いうちに	ちかいうちに
ふさぐ	ふさぐ
かかわる	かかわる
またまた	またまた
売り上げ	うりあげ
３時	さんじ
させていただく	させていただく
しまい	しまい
たやすい	たやすい
と言ってもいい	といってもいい
実際のところ	じっさいのところ
あいさつ	あいさつ
色とりどり	いろとりどり
つぶる	つぶる
わけにはいきません	わけにはいきません
道のり	みちのり
ねる	ねる
no	data
移行	いこう
手先	てさき
大手	おおて
見送り	みおくり
それはそれは	それはそれは
賢明	けんめい
健在	けんざい
ことにより	ことにより
この目で	このめで
面識	めんしき
乾燥	かんそう
片足	かたあし
冴える	さえる
適度	てきど
必然的	ひつぜんてき
心の準備	こころのじゅんび
承認	しょうにん
端から	はしから
古びる	ふるびる
気分が悪い	きぶんがわるい
最小限	さいしょうげん
まいか	まいか
同席	どうせき
安らか	やすらか
娯楽	ごらく
大統領	だいとうりょう
読み上げる	よみあげる
まんまと	まんまと
何千	なんぜん
談笑	だんしょう
仕返し	しかえし
毎度	まいど
取り合う	とりあう
子孫	しそん
弱まる	よわまる
お見通し	おみとおし
旅に出る	たびにでる
盛り上げる	もりあげる
思い通り	おもいどおり
腹を立てる	はらをたてる
ごゆっくり	ごゆっくり
運用	うんよう
簡潔	かんけつ
満つ	みつ
もち	もち
絶つ	たつ
追い返す	おいかえす
一様	いちよう
改良	かいりょう
ベース	ベース
間際	まぎわ
限度	げんど
何か用	なんかよう
退散	たいさん
多大	ただい
とどめる	とどめる
発覚	はっかく
空想	くうそう
泊める	とめる
語り合う	かたりあう
手っ取り早い	てっとりばやい
ガタガタ	ガタガタ
懲りる	こりる
自負	じふ
どうやったら	どうやったら
お世辞	おせじ
形跡	けいせき
依存	いぞん
割く	さく
確立	かくりつ
充満	じゅうまん
言い過ぎる	いいすぎる
接点	せってん
入れ	いれ
この上	このうえ
数千	すうせん
業界	ぎょうかい
素朴	そぼく
絶大	ぜつだい
勇敢	ゆうかん
その下に	そのしたに
味がする	あじがする
乗り気	のりき
さい	さい
おかげさまで	おかげさまで
自分のために	じぶんのために
細かいこと	こまかいこと
３	さん
早く	はやく
話し声	はなしごえ
そうとも	そうとも
想像がつく	そうぞうがつく
次に	つぎに
まったい	まったい
かす	かす
３回	さんかい
かわる	かわる
踏みにじる	ふみにじる
思いつき	おもいつき
石	こく
対	つい
悪気	わるぎ
同一	どういつ
反映	はんえい
注意深い	ちゅういぶかい
隅々	すみずみ
中間	ちゅうかん
解明	かいめい
中学校	ちゅうがっこう
出産	しゅっさん
サッカー	サッカー
押し上げる	おしあげる
郊外	こうがい
親族	しんぞく
弁解	べんかい
不運	ふうん
何時間	なんじかん
審査	しんさ
怖い顔	こわいかお
強まる	つよまる
取り入れる	とりいれる
株	かぶ
実質	じっしつ
小石	こいし
誠に	まことに
臭	しゅう
無知	むち
人柄	ひとがら
見苦しい	みぐるしい
名称	めいしょう
漢字	かんじ
次ぐ	つぐ
印刷	いんさつ
活発	かっぱつ
沿う	そう
発明	はつめい
苦	く
参考になる	さんこうになる
制	せい
過激	かげき
っぱ	っぱ
職務	しょくむ
会合	かいごう
暮れる	くれる
番目	ばんめ
表明	ひょうめい
無口	むくち
喜ばしい	よろこばしい
センター	センター
数回	すうかい
念入り	ねんいり
だるい	だるい
消化	しょうか
間隔	かんかく
良好	りょうこう
押し切る	おしきる
全面的	ぜんめんてき
蓄える	たくわえる
何物	なにもの
強要	きょうよう
コミュニケーション	コミュニケーション
日中	にっちゅう
かる	かる
愛想	あいそ
視野	しや
産	さん
辞退	じたい
愛す	あいす
意義	いぎ
過ぎ去る	すぎさる
期限	きげん
早まる	はやまる
参考にする	さんこうにする
注意を払う	ちゅういをはらう
範囲内	はんいない
ギャップ	ギャップ
発行	はっこう
食後	しょくご
依然として	いぜんとして
その道	そのみち
か否か	かいなか
主要	しゅよう
し始める	しはじめる
アプローチ	アプローチ
然	ぜん
どころではない	どころではない
目につく	めにつく
閉じこもる	とじこもる
かわり	かわり
くの	くの
際に	さいに
身なり	みなり
そろえる	そろえる
うつる	うつる
ふるう	ふるう
たたえる	たたえる
ふだん	ふだん
年ぶり	ねんぶり
そのくせ	そのくせ
行	ぎょう
米	べい
着用	ちゃくよう
前者	ぜんしゃ
待遇	たいぐう
乗客	じょうきゃく
要領	ようりょう
復興	ふっこう
日課	にっか
ステップ	ステップ
色彩	しきさい
需要	じゅよう
打ち切る	うちきる
元来	がんらい
衝撃的	しょうげきてき
乗り出す	のりだす
を巡って	をめぐって
写す	うつす
連日	れんじつ
一から	いちから
総合	そうごう
出版	しゅっぱん
無関心	むかんしん
主催	しゅさい
一目見る	ひとめみる
自分一人	じぶんひとり
打	だ
葬式	そうしき
肉体的	にくたいてき
につれ	につれ
仕立てる	したてる
糧	かて
乱れ	みだれ
署名	しょめい
就任	しゅうにん
見通し	みとおし
縮まる	ちぢまる
見通す	みとおす
順	じゅん
どうしてる	どうしてる
夜が明ける	よがあける
呼び名	よびな
一軒	いっけん
破綻	はたん
長生き	ながいき
洗練	せんれん
同居	どうきょ
終始	しゅうし
そうでない	そうでない
経歴	けいれき
和らぐ	やわらぐ
料金	りょうきん
減少	げんしょう
立ち上げる	たちあげる
対話	たいわ
備わる	そなわる
オープン	オープン
路上	ろじょう
際立つ	きわだつ
分間	ふんかん
故障	こしょう
投資	とうし
安心感	あんしんかん
感情的	かんじょうてき
共同	きょうどう
良心	りょうしん
組み立てる	くみたてる
日間	ひあい
古くから	ふるくから
関東	かんとう
発売	はつばい
夜遅く	よるおそく
悪者	わるもの
金銭	きんせん
災害	さいがい
しく	しく
まく	まく
一端	いったん
困ったこと	こまったこと
損なう	そこなう
すます	すます
わきまえる	わきまえる
めったに	めったに
結びつく	むすびつく
うら	うら
結びつける	むすびつける
見当がつく	けんとうがつく
にあたり	にあたり
支払い	しはらい
かぶせる	かぶせる
ありのまま	ありのまま
けが	けが
手をつける	てをつける
あおる	あおる
早すぎる	はやすぎる
ばかりか	ばかりか
立ち会う	たちあう
顧みる	かえりみる
このところ	このところ
しかた	しかた
次	じ
各	おのおの
中にも	なかにも
不都合	ふつごう
短期間	たんきかん
気がある	きがある
世話をする	せわをする
撤回	てっかい
半数	はんすう
方向性	ほうこうせい
後押し	あとおし
断固	だんこ
収集	しゅうしゅう
平日	へいじつ
軽快	けいかい
実物	じつぶつ
想像力	そうぞうりょく
理想的	りそうてき
思う存分	おもうぞんぶん
軸	じく
痛感	つうかん
沖	おき
集	しゅう
改まる	あらたまる
注視	ちゅうし
災難	さいなん
劇的	げきてき
効率的	こうりつてき
遅れ	おくれ
印象的	いんしょうてき
身元	みもと
中心部	ちゅうしんぶ
負	ふ
に当たり	にあたり
政策	せいさく
直面	ちょくめん
初めに	はじめに
料	りょう
偏見	へんけん
歴史的	れきしてき
設立	せつりつ
転じる	てんじる
ならでは	ならでは
格段	かくだん
繁栄	はんえい
人気がある	にんきがある
事実上	じじつじょう
インタビュー	インタビュー
かかわらず	かかわらず
責任を持つ	せきにんをもつ
混雑	こんざつ
面積	めんせき
代える	かえる
調	ちょう
催す	もよおす
導入	どうにゅう
メーカー	メーカー
学生時代	がくせいじだい
南部	なんぶ
不公平	ふこうへい
に限らず	にかぎらず
も一つ	もひとつ
生き生き	いきいき
早める	はやめる
存続	そんぞく
痛める	いためる
このため	このため
と見られる	とみられる
農家	のうか
情勢	じょうせい
いと	いと
たびたび	たびたび
かれる	かれる
ことし	ことし
１万	いちまん
ふた	ふた
２週間	にしゅうかん
あさ	あさ
インド	インド
みずから	みずから
１０日	とおか
ありあり	ありあり
このように	このように
かけ離れる	かけはなれる
さえない	さえない
１０時	じゅうじ
なれる	なれる
みなす	みなす
５日	いつか
またがる	またがる
４年	よねん
とらわれる	とらわれる
急に	きゅうに
心がける	こころがける
はねる	はねる
心身	しんしん
５	ご
４つ	よっつ
見なす	みなす
しのぐ	しのぐ
末	まつ
着	ちゃく
文書	ぶんしょ
尽力	じんりょく
診断	しんだん
交互に	こうごに
日程	にってい
請求	せいきゅう
毎日毎日	まいにちまいにち
浸透	しんとう
省く	はぶく
悩ます	なやます
必要性	ひつようせい
その一方	そのいっぽう
妨げる	さまたげる
便	びん
費	ひ
脱する	だっする
正午	しょうご
典型的	てんけいてき
親しみ	したしみ
容疑	ようぎ
営む	いとなむ
日常生活	にちじょうせいかつ
実質的	じっしつてき
手法	しゅほう
格別	かくべつ
適用	てきよう
着実	ちゃくじつ
順序	じゅんじょ
実態	じったい
no	data
全体で	ぜんたいで
改革	かいかく
無条件	むじょうけん
受け付ける	うけつける
付け	つけ
転落	てんらく
措置	そち
歴代	れきだい
毎月	まいつき
富む	とむ
極度	きょくど
戦後	せんご
言い渡す	いいわたす
従来	じゅうらい
試み	こころみ
日常的	にちじょうてき
柔軟	じゅうなん
掲載	けいさい
担当者	たんとうしゃ
世界的	せかいてき
防止	ぼうし
病気になる	びょうきになる
経済的	けいざいてき
横浜	よこはま
自分なり	じぶんなり
発信	はっしん
言及	げんきゅう
県	けん
実施	じっし
近年	きんねん
普及	ふきゅう
原則	げんそく
訴え	うったえ
進出	しんしゅつ
住宅	じゅうたく
携わる	たずさわる
インターネット	インターネット
転換	てんかん
ビジネス	ビジネス
産業	さんぎょう
第一歩	だいいっぽ
自立	じりつ
民間	みんかん
定着	ていちゃく
望ましい	のぞましい
好	こう
長期	ちょうき
不当	ふとう
影響を及ぼす	えいきょうをおよぼす
厳格	げんかく
個別	こべつ
協議	きょうぎ
メディア	メディア
規制	きせい
４時	よじ
５時	ごじ
４月	しがつ
ためる	ためる
当てはまる	あてはまる
８時	はちじ
思いやり	おもいやり
はじめとする	はじめとする
４日	よっか
ならう	ならう
９時	くじ
６時	ろくじ
７時	しちじ
つなげる	つなげる
合意	ごうい
観点	かんてん
全般	ぜんぱん
教訓	きょうくん
両国	りょうこく
景気	けいき
会見	かいけん
輸入	ゆにゅう
意欲	いよく
余儀なくされる	よぎなくされる
相次ぐ	あいつぐ
役割を果たす	やくわりをはたす
国際	こくさい
緩和	かんわ
不可欠	ふかけつ
先立つ	さきだつ
東京都	とうきょうと
打ち出す	うちだす
幅広い	はばひろい
冒頭	ぼうとう
平成	へいせい
に基づいて	にもとづいて
魔物	まもの
俺達	おれたち
殿下	でんか
婚約者	こんやくしゃ
令嬢	れいじょう
勇者	ゆうしゃ
魔王	まおう
陛下	へいか
スキル	スキル
隊長	たいちょう
魔術	まじゅつ
魔女	まじょ
国王	こくおう
王都	おうと
お姉	おねえ
結界	けっかい
帝国	ていこく
頰	ほお
嬢	じょう
伯爵	はくしゃく
姉さん	ねえさん
精霊	せいれい
スマホ	スマホ
族	ぞく
召喚	しょうかん
王族	おうぞく
使用人	しようにん
おっぱい	おっぱい
公爵	こうしゃく
王女	おうじょ
筈	はず
水着	みずぎ
ウチ	ウチ
父上	ちちうえ
刑事	けいじ
勿論	もちろん
魔法使い	まほうつかい
声を掛ける	こえをかける
兵器	へいき
討伐	とうばつ
エッチ	エッチ
クラスメイト	クラスメイト
将軍	しょうぐん
噓	うそ
妖精	ようせい
ボス	ボス
流石に	さすがに
騎士団	きしだん
種族	しゅぞく
領地	りょうち
属性	ぞくせい
リビング	リビング
寮	りょう
兄様	にいさま
侍女	じじょ
冒険者	ぼうけんしゃ
貴女	きじょ
王宮	おうきゅう
異世界	いせかい
アイテム	アイテム
龍	りゅう
洞窟	どうくつ
ランク	ランク
変身	へんしん
アンタ	アンタ
このうち	このうち
身につく	みにつく
じゃねー	じゃねー
基づく	もとづく
オレ	オレ
アイツ	アイツ
ボク	ボク
３月	さんがつ
キミ	キミ
はじめに	はじめに
ハァ	ハァ
そなた	そなた
きみ	きみ
石	せき
モンスター	モンスター
近付く	ちかづく
領	りょう
領主	りょうしゅ
弾丸	だんがん
街道	かいどう
双子	ふたご
嚙む	かむ
王様	おうさま
ドラゴン	ドラゴン
転移	てんい
ギルド	ギルド
当主	とうしゅ
執事	しつじ
魔術師	まじゅつし
○	まる
里	さと
兄ちゃん	にいちゃん
喰らう	くらう
皇帝	こうてい
王家	おうけ
相棒	あいぼう
お前さん	おまえさん
旦那様	だんなさま
狩る	かる
漆黒	しっこく
前世	ぜんせい
摑む	つかむ
ヒロイン	ヒロイン
暗殺	あんさつ
祭	まつり
エレベーター	エレベーター
お嬢	おじょう
団長	だんちょう
呻く	うめく
飛行	ひこう
店長	てんちょう
王妃	おうひ
生徒会	せいとかい
聖女	せいじょ
神殿	しんでん
呟き	つぶやき
強張る	こわばる
姉ちゃん	ねえちゃん
マント	マント
巨体	きょたい
プレイ	プレイ
声音	せいおん
股間	こかん
鞘	さや
平民	へいみん
クッキー	クッキー
何処	どこ
エリア	エリア
討つ	うつ
厨房	ちゅうぼう
叩き込む	たたきこむ
村人	むらびと
つーか	つーか
云う	いう
弾く	はじく
足下	あしもと
侯爵	こうしゃく
屋台	やたい
息を呑む	いきをのむ
加護	かご
盗賊	とうぞく
クリスマス	クリスマス
仕留める	しとめる
ねん	ねん
卿	きょう
探偵	たんてい
訊ねる	たずねる
使者	ししゃ
激突	げきとつ
細める	ほそめる
方が良い	ほうがいい
ぬいぐるみ	ぬいぐるみ
事はない	ことはない
no	data
コイツ	コイツ
首をかしげる	くびをかしげる
アタシ	アタシ
さー	さー
ご主人様	ごしゅじんさま
ハア	ハア
パーティ	パーティ
うしろ	うしろ
ウサギ	ウサギ
なにせ	なにせ
アハハ	アハハ
気持	きもち
分る	わかる
コレ	コレ
見やる	みやる
ううむ	ううむ
仰る	おっしゃる
おじいちゃん	おじいちゃん
ぜんぜん	ぜんぜん
警官	けいかん
唾液	だえき
ワンピース	ワンピース
薔薇	ばら
ロボット	ロボット
軍人	ぐんじん
拳銃	けんじゅう
ピアノ	ピアノ
部員	ぶいん
握り締める	にぎりしめる
蹴り	けり
病室	びょうしつ
包帯	ほうたい
じゃろう	じゃろう
従者	じゅうしゃ
事にする	ことにする
見張り	みはり
乳首	ちくび
むむ	むむ
銃声	じゅうせい
ちん	ちん
躊躇う	ためらう
坊	ぼう
ロープ	ロープ
くすくす	くすくす
締め付ける	しめつける
カフェ	カフェ
結晶	けっしょう
広間	ひろま
ヶ	ヶ
砂漠	さばく
叔父	おじ
巫女	みこ
大将	たいしょう
テント	テント
モニター	モニター
絶頂	ぜっちょう
部室	ぶしつ
潜入	せんにゅう
感知	かんち
邪悪	じゃあく
お陰で	おかげで
鋼	はがね
マイク	マイク
気持ち良い	きもちいい
剣士	けんし
怯む	ひるむ
バイク	バイク
治癒	ちゆ
ローブ	ローブ
蠢く	うごめく
庭園	ていえん
抱き締める	だきしめる
解る	わかる
フロア	フロア
檻	おり
包囲	ほうい
咆哮	ほうこう
乳房	ちぶさ
ああん	ああん
推理	すいり
軋む	きしむ
雫	しずく
如き	ごとき
胴体	どうたい
戦術	せんじゅつ
閣下	かっか
男爵	だんしゃく
煙草	たばこ
無傷	むきず
決闘	けっとう
轟音	ごうおん
突き立てる	つきたてる
フード	フード
魔法陣	まほうじん
ぶっちゃける	ぶっちゃける
体育館	たいいくかん
耐性	たいせい
長身	ちょうしん
向う	むかう
ソファー	ソファー
はー	はー
一ヶ月	いっかげつ
凍りつく	こおりつく
灯り	あかり
あははは	あははは
ネズミ	ネズミ
悲鳴をあげる	ひめいをあげる
ツッコミ	ツッコミ
クズ	クズ
おっきい	おっきい
だいじょうぶ	だいじょうぶ
デカい	デカい
なにしろ	なにしろ
我らが	われらが
間合い	まあい
ふい	ふい
ご主人	ごしゅじん
あのう	あのう
あいだ	あいだ
炎	えん
真	しん
アイス	アイス
丁度	ちょうど
淹れる	いれる
中々	なかなか
激痛	げきつう
崎	さき
同盟	どうめい
執務室	しつむしつ
補給	ほきゅう
チョコ	チョコ
折角	せっかく
容易い	たやすい
先代	せんだい
砦	とりで
子供達	こどもたち
薬草	やくそう
護る	まもる
突き上げる	つきあげる
習得	しゅうとく
援護	えんご
担任	たんにん
追撃	ついげき
視線を落とす	しせんをおとす
お前達	おまえたち
跳躍	ちょうやく
迷宮	めいきゅう
触手	しょくしゅ
温もり	ぬくもり
エプロン	エプロン
上級	じょうきゅう
壁際	かべぎわ
事が出来る	ことができる
祖母	そぼ
課	か
判る	わかる
凛	りん
酒場	さかば
変装	へんそう
坊主	ぼうず
迂闊	うかつ
草原	そうげん
壊滅	かいめつ
汝	な
その辺り	そのあたり
有る	ある
気合	きあい
閃光	せんこう
筆頭	ひっとう
決戦	けっせん
チケット	チケット
精液	せいえき
ステータス	ステータス
混じり	まじり
ひょっとしたら	ひょっとしたら
鑑定	かんてい
辺境	へんきょう
無し	なし
足止め	あしどめ
繋がり	つながり
列車	れっしゃ
斧	おの
昨晩	さくばん
次期	じき
無様	ぶざま
浄化	じょうか
傭兵	ようへい
凶悪	きょうあく
エロい	エロい
兄上	あにうえ
短剣	たんけん
歩き始める	あるきはじめる
遺跡	いせき
水晶	すいしょう
っつー	っつー
殲滅	せんめつ
邸	てい
あの娘	あのこ
絡みつく	からみつく
溜息	ためいき
まー	まー
思いだす	おもいだす
クマ	クマ
殆ど	ほとんど
切り札	きりふだ
ゆう	ゆう
キレイ	キレイ
太もも	ふともも
お主	おぬし
あはははは	あはははは
つづく	つづく
ン	ン
はっはっは	はっはっは
ご存知	ごぞんじ
裏切り者	うらぎりもの
舞	まい
飛びかかる	とびかかる
照れくさい	てれくさい
すてき	すてき
絨毯	じゅうたん
文化祭	ぶんかさい
ちょっぴり	ちょっぴり
剣術	けんじゅつ
チョコレート	チョコレート
消失	しょうしつ
ぎょっと	ぎょっと
蝶	ちょう
秘書	ひしょ
体育	たいいく
特訓	とっくん
嫁ぐ	とつぐ
ランプ	ランプ
一年生	いちねんせい
受け流す	うけながす
なんざ	なんざ
江戸	えど
瞬く間に	またたくまに
腹部	ふくぶ
配下	はいか
物資	ぶっし
宴	うたげ
帝	みかど
妾	めかけ
三階	さんがい
訳じゃない	わけじゃない
嘆息	たんそく
制圧	せいあつ
パーセント	パーセント
蜜	みつ
妖怪	ようかい
その事	そのこと
ダンジョン	ダンジョン
命中	めいちゅう
てめぇ	てめぇ
称号	しょうごう
助手	じょしゅ
侵入者	しんにゅうしゃ
ベルト	ベルト
恐い	こわい
回り込む	まわりこむ
シャッター	シャッター
校内	こうない
エルフ	エルフ
狐	きつね
セックス	セックス
看護師	かんごし
きゅっと	きゅっと
恰好	かっこう
身に着ける	みにつける
革	かわ
スルー	スルー
詠唱	えいしょう
マスク	マスク
至近距離	しきんきょり
料理人	りょうりにん
唖然	あぜん
妃	ひ
火傷	やけど
コンクリート	コンクリート
絵を描く	えをかく
虚空	こくう
無敵	むてき
図書室	としょしつ
流石	さすが
処	ところ
異国	いこく
必殺	ひっさつ
之	これ
亀裂	きれつ
幻覚	げんかく
蹂躙	じゅうりん
金貨	きんか
役人	やくにん
燃え上がる	もえあがる
為す	なす
っしょ	っしょ
零れる	こぼれる
射精	しゃせい
もじもじ	もじもじ
片付け	かたづけ
開閉	かいへい
距離を詰める	きょりをつめる
すげぇ	すげぇ
ぜんぶ	ぜんぶ
それより	それより
ワシ	ワシ
友だち	ともだち
メガネ	メガネ
やけど	やけど
幼なじみ	おさななじみ
あした	あした
ちょいと	ちょいと
暫く	しばらく
故に	ゆえに
ぬう	ぬう
幼馴染	おさななじみ
忌々しい	いまいましい
カバン	カバン
我が国	わがくに
教	きょう
浮遊	ふゆう
電波	でんぱ
渾身	こんしん
女房	にょうぼう
装着	そうちゃく
守護	しゅご
前線	ぜんせん
迎撃	げいげき
俺様	おれさま
訝しい	いぶかしい
個体	こたい
研究室	けんきゅうしつ
郎	ろう
紋章	もんしょう
初心者	しょしんしゃ
奇襲	きしゅう
民衆	みんしゅう
混沌	こんとん
目を瞑る	めをつぶる
残骸	ざんがい
顔を背ける	かおをそむける
羞恥	しゅうち
鼻で笑う	はなでわらう
鍛錬	たんれん
園	その
喘ぐ	あえぐ
学院	がくいん
呪	じゅ
逢う	あう
跳ね上がる	はねあがる
接続	せつぞく
戦慄	せんりつ
瞬く	しばたたく
玉座	ぎょくざ
恋人同士	こいびとどうし
基地	きち
こくり	こくり
ジャンプ	ジャンプ
指揮官	しきかん
ブロック	ブロック
雑魚	ざこ
男達	おとこだて
またも	またも
致命傷	ちめいしょう
化ける	ばける
銃弾	じゅうだん
侍	さむらい
髭	ひげ
おめえ	おめえ
灯る	ともる
転生	てんせい
愛人	あいじん
呑み込む	のみこむ
鱗	うろこ
衆	しゅう
手を繋ぐ	てをつなぐ
工房	こうぼう
壺	つぼ
スパイ	スパイ
白髪	しらが
客人	きゃくじん
妹さん	いもうとさん
神話	しんわ
缶	かん
乗っ取る	のっとる
偵察	ていさつ
ぼーっと	ぼーっと
突っ伏す	つっぷす
将	しょう
新作	しんさく
守	もり
噴く	ふく
ゾンビ	ゾンビ
跪く	ひざまずく
解	かい
占い	うらない
寝台	しんだい
案件	あんけん
反転	はんてん
言葉に詰まる	ことばにつまる
いままで	いままで
こみ上げる	こみあげる
見つめ合う	みつめあう
口をつぐむ	くちをつぐむ
おぞましい	おぞましい
けども	けども
メシ	メシ
事ができる	ことができる
ちくしょう	ちくしょう
冷ややか	ひややか
かれ	かれ
やわらかい	やわらかい
ワケ	ワケ
口ごもる	くちごもる
そのあたり	そのあたり
ふたたび	ふたたび
ため息を吐く	ためいきをつく
ほお	ほお
死神	しにがみ
クッション	クッション
暗黒	あんこく
にも関わらず	にもかかわらず
虚ろ	うつろ
笛	ふえ
商会	しょうかい
羽目になる	はめになる
数名	すうめい
羊	ひつじ
一万	いちまん
凶器	きょうき
生徒会長	せいとかいちょう
吸血鬼	きゅうけつき
神々	かみがみ
奏でる	かなでる
銃口	じゅうこう
液	えき
理	り
井戸	いど
女子生徒	じょしせいと
何せ	なにせ
絵本	えほん
一団	いちだん
城壁	じょうへき
どする	どする
顔を歪める	かおをゆがめる
ストーカー	ストーカー
身体能力	しんたいのうりょく
虚しい	むなしい
サンドイッチ	サンドイッチ
手を挙げる	てをあげる
武士	ぶし
王城	おうじょう
零す	こぼす
に付いて	について
駐車場	ちゅうしゃじょう
買い取る	かいとる
繫がる	つながる
幾つか	いくつか
仕様	しよう
使い手	つかいて
暗がり	くらがり
挿入	そうにゅう
装甲	そうこう
尋問	じんもん
尾行	びこう
女子高生	じょしこうせい
兎	うさぎ
君達	きみたち
眉を寄せる	まゆをよせる
予定通り	よていどおり
彷徨う	さまよう
浴衣	ゆかた
魅了	みりょう
撃退	げきたい
眼下	がんか
正座	せいざ
炸裂	さくれつ
校門	こうもん
茂み	しげみ
苦々しい	にがにがしい
no	data
ソース	ソース
浸かる	つかる
処女	しょじょ
純白	じゅんぱく
彼女自身	かのじょじしん
脈	みゃく
神官	しんかん
奥歯	おくば
転校	てんこう
宿屋	やどや
伊達	だて
魔獣	まじゅう
変換	へんかん
駆け上がる	かけあがる
滅ぶ	ほろぶ
押し黙る	おしだまる
射撃	しゃげき
課長	かちょう
家出	いえで
集落	しゅうらく
声を張り上げる	こえをはりあげる
リンゴ	リンゴ
後ずさる	あとずさる
まぶた	まぶた
立ちあがる	たちあがる
クラブ	クラブ
さわる	さわる
たずねる	たずねる
つう	つう
アハハハ	アハハハ
出入り口	でいりぐち
じいさん	じいさん
くらう	くらう
訳ではない	わけではない
寄りかかる	よりかかる
けん	けん
まとわりつく	まとわりつく
あいだに	あいだに
土	ど
ぶっ	ぶっ
侵攻	しんこう
男子生徒	だんしせいと
物凄い	ものすごい
一手	いって
無いと	ないと
眼光	がんこう
宮殿	きゅうでん
授業中	じゅぎょうちゅう
階段を上る	かいだんをのぼる
桃	もも
玩具	おもちゃ
瓦礫	がれき
目を凝らす	めをこらす
きょろきょろ	きょろきょろ
先導	せんどう
口の端	くちのは
砲	ほう
弄る	いじる
書斎	しょさい
監禁	かんきん
言葉通り	ことばどおり
要塞	ようさい
全裸	ぜんら
採取	さいしゅ
階層	かいそう
僕達	ぼくたち
紅い	あかい
木製	もくせい
旅人	たびびと
ラーメン	ラーメン
八十	はちじゅう
区画	くかく
レシピ	レシピ
射る	いる
重量	じゅうりょう
側近	そっきん
背筋を伸ばす	せすじをのばす
子爵	ししゃく
難易度	なんいど
手を叩く	てをたたく
力を抜く	ちからをぬく
リアクション	リアクション
白衣	はくい
イエス	イエス
げっ	げっ
急かす	せかす
トンネル	トンネル
保健室	ほけんしつ
某	ぼう
バイバイ	バイバイ
正論	せいろん
トラウマ	トラウマ
銀髪	ぎんぱつ
又	また
双	そう
反則	はんそく
同調	どうちょう
ぶんぶん	ぶんぶん
慈悲	じひ
彼等	かれら
爺	じじ
ごくり	ごくり
命を奪う	いのちをうばう
シート	シート
撒く	まく
宰相	さいしょう
大袈裟	おおげさ
鬱陶しい	うっとうしい
胴	どう
イラスト	イラスト
殺し合う	ころしあう
お嫁さん	およめさん
畜生	ちくしょう
苦悶	くもん
屍	しかばね
プロポーズ	プロポーズ
遊園地	ゆうえんち
車両	しゃりょう
攻撃力	こうげきりょく
もどる	もどる
すげー	すげー
オチ	オチ
現われる	あらわれる
なになに	なになに
ゴメン	ゴメン
うなる	うなる
不意に	ふいに
へい	へい
にやにや	にやにや
コラ	コラ
ゆうべ	ゆうべ
どのみち	どのみち
おじいさん	おじいさん
ぼろぼろ	ぼろぼろ
夕暮れ	ゆうぐれ
変る	かわる
だれか	だれか
とたん	とたん
原	げん
花嫁	はなよめ
羽根	はね
風呂場	ふろば
捻る	ひねる
物理	ぶつり
封	ふう
あんま	あんま
真上	まうえ
想定外	そうていがい
ゲート	ゲート
本命	ほんめい
大男	おおおとこ
斬撃	ざんげき
羽ばたく	はばたく
問答無用	もんどうむよう
軍勢	ぐんぜい
言葉を紡ぐ	ことばをつむぐ
手帳	てちょう
寝転がる	ねころがる
寄越す	よこす
四月	しがつ
千年	せんねん
仮説	かせつ
威圧感	いあつかん
背中を向ける	せなかをむける
たじろぐ	たじろぐ
歌声	うたごえ
言葉を切る	ことばをきる
恐るべき	おそるべき
私服	しふく
溢れ出す	あふれだす
ペニス	ペニス
会議室	かいぎしつ
失踪	しっそう
裏口	うらぐち
水色	みずいろ
信者	しんじゃ
連行	れんこう
シチュエーション	シチュエーション
ゲット	ゲット
膨れる	ふくれる
部外者	ぶがいしゃ
水中	すいちゅう
勧誘	かんゆう
王太子	おうたいし
憶える	おぼえる
罪人	ざいにん
脱がす	ぬがす
魔族	まぞく
紙袋	かみぶくろ
しゃがみ込む	しゃがみこむ
顔を覆う	かおをおおう
ぼうっと	ぼうっと
鶏	にわとり
異形	いぎょう
囮	おとり
有	ゆう
収納	しゅうのう
っつう	っつう
体中	からだじゅう
張り詰める	はりつめる
女優	じょゆう
獅子	しし
ロビー	ロビー
尚	なお
降伏	こうふく
見惚れる	みとれる
水音	みずおと
姫様	ひめさま
縋る	すがる
口に含む	くちにふくむ
子犬	こいぬ
引き留める	ひきとめる
回想	かいそう
襲い掛かる	おそいかかる
たん	たん
大分	だいぶ
花びら	はなびら
ぬぐう	ぬぐう
腕組み	うでぐみ
まじ	まじ
切っ先	きっさき
なにも	なにも
うわさ	うわさ
クソッ	クソッ
見習い	みならい
はずす	はずす
溜息をつく	ためいきをつく
おそるおそる	おそるおそる
頑な	かたくな
かわいらしい	かわいらしい
ウフフ	ウフフ
おにぎり	おにぎり
わるい	わるい
これぐらい	これぐらい
色合い	いろあい
おやつ	おやつ
月明かり	つきあかり
バッチリ	バッチリ
聖	ひじり
羽	わ
no	data
系統	けいとう
勝者	しょうしゃ
四肢	しし
強敵	きょうてき
脆い	もろい
謁見	えっけん
素手	すで
お茶会	おちゃかい
分解	ぶんかい
レア	レア
はしたない	はしたない
そんで	そんで
出力	しゅつりょく
プレイヤー	プレイヤー
初恋	はつこい
程に	ほどに
五月	ごがつ
咥える	くわえる
殺到	さっとう
滴る	したたる
孕む	はらむ
細身	ほそみ
冷気	れいき
凶暴	きょうぼう
警護	けいご
声色	こわいろ
部品	ぶひん
肩を竦める	かたをすくめる
機体	きたい
逡巡	しゅんじゅん
着信音	ちゃくしんおん
出来るだけ	できるだけ
サラダ	サラダ
賊	ぞく
突き	つき
悪役	あくやく
己が	おのが
傷を負う	きずをおう
噴水	ふんすい
小首を傾げる	こくびをかしげる
ライブ	ライブ
ラジオ	ラジオ
一際	ひときわ
オーケー	オーケー
星空	ほしぞら
消し去る	けしさる
特化	とっか
口説く	くどく
貫通	かんつう
ぼやく	ぼやく
膨れ上がる	ふくれあがる
お喋り	おしゃべり
捕獲	ほかく
愛撫	あいぶ
創造	そうぞう
と言うか	というか
躱す	かわす
蜘蛛	くも
エスコート	エスコート
敵に回す	てきにまわす
耐えきれる	たえきれる
ガード	ガード
悶える	もだえる
相対	そうたい
薪	まき
粉砕	ふんさい
no	data
飛び立つ	とびたつ
お皿	おさら
そういうことなら	そういうことなら
ぐちゃぐちゃ	ぐちゃぐちゃ
生身	なまみ
シルエット	シルエット
込み上げる	こみあげる
早足	はやあし
目玉	めだま
身を起こす	みをおこす
コスプレ	コスプレ
引き締める	ひきしめる
やない	やない
パンチ	パンチ
楽園	らくえん
着信	ちゃくしん
大人びる	おとなびる
おやじ	おやじ
くれてやる	くれてやる
おばちゃん	おばちゃん
うめき声	うめきごえ
口づけ	くちづけ
おおよそ	おおよそ
あらわれる	あらわれる
なんだっけ	なんだっけ
あてがう	あてがう
ギュッと	ギュッと
さきほど	さきほど
ズル	ズル
キャー	キャー
がっくり	がっくり
悪党	あくとう
旅館	りょかん
偽装	ぎそう
遂に	ついに
得体の知れない	えたいのしれない
体型	たいけい
パジャマ	パジャマ
三月	さんがつ
ひんやり	ひんやり
手綱	たづな
シリーズ	シリーズ
皆殺し	みなごろし
香	こう
交差	こうさ
梅	うめ
目をつぶる	めをつぶる
閃く	ひらめく
変形	へんけい
隊員	たいいん
幻影	げんえい
給仕	きゅうじ
無くす	なくす
治める	おさめる
ロック	ロック
オリジナル	オリジナル
近衛	このえ
当然ながら	とうぜんながら
注ぎ込む	そそぎこむ
不能	ふのう
酸素	さんそ
破壊力	はかいりょく
即死	そくし
か細い	かぼそい
刺繍	ししゅう
プリント	プリント
嫌悪感	けんおかん
サンキュー	サンキュー
出掛ける	でかける
携える	たずさえる
融合	ゆうごう
取得	しゅとく
あご	あご
はて	はて
半身	はんしん
ぴくり	ぴくり
ビクビク	ビクビク
手の平	てのひら
廃墟	はいきょ
祭壇	さいだん
片腕	かたうで
数値	すうち
道場	どうじょう
創る	つくる
時間を稼ぐ	じかんをかせぐ
死骸	しがい
馬鹿げる	ばかげる
封鎖	ふうさ
健気	けなげ
隣国	りんごく
人体	じんたい
職員室	しょくいんしつ
独り	ひとり
押し潰す	おしつぶす
爺さん	じいさん
対戦	たいせん
自我	じが
興味津々	きょうみしんしん
他ならない	ほかならない
揉める	もめる
パーツ	パーツ
眼球	がんきゅう
喉を鳴らす	のどをならす
引き締まる	ひきしまる
第五	だいご
距離感	きょりかん
返信	へんしん
するり	するり
脱力	だつりょく
いじめ	いじめ
コ	コ
かけら	かけら
ソレ	ソレ
ひとしきり	ひとしきり
よぎる	よぎる
マネ	マネ
むろん	むろん
かたち	かたち
こんど	こんど
どいつもこいつも	どいつもこいつも
おんなじ	おんなじ
名残惜しい	なごりおしい
噛みしめる	かみしめる
まみれ	まみれ
そういや	そういや
落ちつく	おちつく
かわりに	かわりに
よける	よける
グッと	グッと
口をつける	くちをつける
水	すい
側	そば
空く	すく
素	もと
宮廷	きゅうてい
砂浜	すなはま
棘	とげ
細胞	さいぼう
攫う	さらう
死角	しかく
手持ち	てもち
グラウンド	グラウンド
勝敗	しょうはい
階下	かいか
婚姻	こんいん
十歳	じゅっさい
亀	かめ
校長	こうちょう
魔道	まどう
両肩	りょうかた
思い至る	おもいいたる
運び込む	はこびこむ
地形	ちけい
勝ち目	かちめ
香水	こうすい
刀身	とうしん
近隣	きんりん
体を起こす	からだをおこす
一組	ひとくみ
反	はん
不味い	まずい
懸ける	かける
敬礼	けいれい
万一	まんいち
鷹	たか
組み込む	くみこむ
実体	じったい
優	ゆう
鼻息	はないき
呆ける	ぼける
怒声	どせい
連絡先	れんらくさき
編む	あむ
判別	はんべつ
思いきや	おもいきや
砕け散る	くだけちる
人混み	ひとごみ
堪る	たまる
目配せ	めくばせ
微動	びどう
兵隊	へいたい
波打つ	なみうつ
しょんぼり	しょんぼり
拡散	かくさん
応答	おうとう
微笑みかける	ほほえみかける
勝ち誇る	かちほこる
御用	ごよう
損傷	そんしょう
殿	との
強度	きょうど
ぼやける	ぼやける
視覚	しかく
絹	きぬ
強者	きょうしゃ
吊り上げる	つりあげる
衛兵	えいへい
毛皮	けがわ
洗脳	せんのう
無残	むざん
セクハラ	セクハラ
鈍感	どんかん
別荘	べっそう
端末	たんまつ
たった一つ	たったひとつ
両目	りょうめ
喚く	わめく
路	じ
こぼれ落ちる	こぼれおちる
引きこもる	ひきこもる
先ほどから	さきほどから
１番	いちばん
ははあ	ははあ
なにもない	なにもない
これっぽっち	これっぽっち
チラリ	チラリ
あだ名	あだな
多め	おおめ
詫びる	わびる
ふつう	ふつう
ムダ	ムダ
アア	アア
ひらく	ひらく
ひときわ	ひときわ
まじめ	まじめ
浮き上がる	うきあがる
足手まとい	あしでまとい
サラ	サラ
かき消す	かきけす
この度	このたび
里	り
塾	じゅく
軍団	ぐんだん
障壁	しょうへき
門番	もんばん
では無い	ではない
Ｔシャツ	ティーシャツ
ジャケット	ジャケット
火照る	ほてる
打ち付ける	うちつける
即ち	すなわち
山道	やまみち
恍惚	こうこつ
小指	こゆび
極まりない	きわまりない
滑り込む	すべりこむ
領土	りょうど
ジ	ジ
轟く	とどろく
付与	ふよ
あっと	あっと
世間話	せけんばなし
重々しい	おもおもしい
時間稼ぎ	じかんかせぎ
前置き	まえおき
愚か者	おろかもの
宙に浮く	ちゅうにうく
逝く	いく
たま	たま
場違い	ばちがい
重傷	じゅうしょう
首輪	くびわ
赤面	せきめん
ゴム	ゴム
村長	そんちょう
異質	いしつ
蒼い	あおい
伸びをする	のびをする
辛うじて	かろうじて
脱ぎ捨てる	ぬぎすてる
高位	こうい
アクセサリー	アクセサリー
補佐	ほさ
面接	めんせつ
吐き気	はきけ
剣を抜く	つるぎをぬく
の様に	のように
留学	りゅうがく
何処か	どこか
伝承	でんしょう
母ちゃん	かあちゃん
隔離	かくり
お仕置き	おしおき
石畳	いしだたみ
飛び回る	とびまわる
咳	せき
授かる	さずかる
ファイル	ファイル
援軍	えんぐん
儀	ぎ
子猫	こねこ
飛び越える	とびこえる
目を見張る	めをみはる
赤子	あかご
真下	ました
編集	へんしゅう
切り替わる	きりかわる
血が流れる	ちがながれる
迷子	まいご
撃破	げきは
躍る	おどる
継承	けいしょう
だからと言って	だからといって
舌を出す	したをだす
至急	しきゅう
同胞	どうほう
合宿	がっしゅく
仇	あだ
騎	き
言葉を返す	ことばをかえす
目尻	めじり
腕力	わんりょく
後継者	こうけいしゃ
ハ	ハ
ちっぽけ	ちっぽけ
ほー	ほー
結局のところ	けっきょくのところ
２階	にかい
引き渡す	ひきわたす
引き止める	ひきとめる
しかしながら	しかしながら
たどりつく	たどりつく
おまえら	おまえら
呼び出し	よびだし
ぎゃあ	ぎゃあ
振りかぶる	ふりかぶる
はじく	はじく
モン	モン
えっち	えっち
音をたてる	おとをたてる
裏手	うらて
ずるずる	ずるずる
丸ごと	まるごと
軽	けい
立ち位置	たちいち
二年生	にねんせい
各種	かくしゅ
貪る	むさぼる
心の声	こころのこえ
突き抜ける	つきぬける
開け放つ	あけはなつ
逃げ切る	にげきる
警備員	けいびいん
態度を取る	たいどをとる
まじまじ	まじまじ
地下室	ちかしつ
老婆	ろうば
心当たりがある	こころあたりがある
進学	しんがく
論理	ろんり
赤らめる	あからめる
防具	ぼうぐ
四角い	しかくい
特徴的	とくちょうてき
感慨	かんがい
幾つも	いくつも
もぐもぐ	もぐもぐ
名刺	めいし
月光	げっこう
トマト	トマト
ゴブリン	ゴブリン
諦め	あきらめ
様になる	ようになる
特製	とくせい
体当たり	たいあたり
遺産	いさん
むっと	むっと
駆け巡る	かけめぐる
芸	げい
お宅	おたく
暗殺者	あんさつしゃ
冷酷	れいこく
ぐいぐい	ぐいぐい
子息	しそく
殻	から
遠巻き	とおまき
コンビ	コンビ
儂	わし
哲学	てつがく
遠距離	えんきょり
恨めしい	うらめしい
心外	しんがい
協力者	きょうりょくしゃ
花束	はなたば
危惧	きぐ
空白	くうはく
背丈	せたけ
燃料	ねんりょう
静けさ	しずけさ
雑草	ざっそう
ごろごろ	ごろごろ
狂	きょう
牢	ろう
生気	せいき
真夜中	まよなか
野生	やせい
可	か
帝都	ていと
スピーカー	スピーカー
数歩	すうほ
診察	しんさつ
正門	せいもん
遡る	さかのぼる
堕ちる	おちる
長ける	たける
受話器	じゅわき
陰謀	いんぼう
ままならない	ままならない
敢えて	あえて
しょせん	しょせん
いっしょ	いっしょ
ゴロゴロ	ゴロゴロ
以て	もって
フリをする	フリをする
びくびく	びくびく
マンガ	マンガ
ピッタリ	ピッタリ
持ち物	もちもの
ばらばら	ばらばら
手をつく	てをつく
じい	じい
なぜだか	なぜだか
おもう	おもう
と言って	といって
わき	わき
死にかける	しにかける
こたえる	こたえる
頃合い	ころあい
いいとこ	いいとこ
だれも	だれも
値	ち
頬を染める	ほおをそめる
窮地	きゅうち
城内	じょうない
亡霊	ぼうれい
恐らくは	おそらくは
生命力	せいめいりょく
香りがする	かおりがする
マスコミ	マスコミ
蹴散らす	けちらす
ストーリー	ストーリー
行き交う	ゆきかう
コード	コード
気圧される	けおされる
部署	ぶしょ
派閥	はばつ
ガンガン	ガンガン
反乱	はんらん
変貌	へんぼう
マナー	マナー
実のところ	じつのところ
大剣	たいけん
オレンジ	オレンジ
手下	てした
大概	たいがい
小動物	しょうどうぶつ
血筋	ちすじ
文学	ぶんがく
大歓迎	だいかんげい
切り抜ける	きりぬける
生成	せいせい
不本意	ふほんい
立て続け	たてつづけ
キモイ	キモイ
経験値	けいけんち
宿命	しゅくめい
ぽんぽん	ぽんぽん
要	よう
家臣	かしん
シナリオ	シナリオ
御者	ぎょしゃ
九時	くじ
役員	やくいん
劇場	げきじょう
極限	きょくげん
恐れ入る	おそれいる
家柄	いえがら
上層部	じょうそうぶ
カラオケ	カラオケ
無駄にする	むだにする
九十	きゅうじゅう
保険	ほけん
しっとり	しっとり
眩い	まばゆい
スライム	スライム
わっと	わっと
初代	しょだい
舟	ふね
視力	しりょく
常人	じょうじん
一人暮らし	ひとりぐらし
デスク	デスク
締まる	しまる
粒子	りゅうし
三時	さんじ
悠然	ゆうぜん
消え失せる	きえうせる
沸騰	ふっとう
膣	ちつ
ずらり	ずらり
陣取る	じんどる
若き	わかき
握り返す	にぎりかえす
獣人	じゅうじん
陽光	ようこう
急所	きゅうしょ
桃色	ももいろ
部位	ぶい
びくりと	びくりと
ちゅう	ちゅう
見舞い	みまい
スッキリ	スッキリ
てっぺん	てっぺん
終る	おわる
おぬし	おぬし
いい男	いいおとこ
あーん	あーん
こわばる	こわばる
われ	われ
今日のところは	きょうのところは
ステキ	ステキ
ぬく	ぬく
思いきり	おもいきり
手すり	てすり
さよう	さよう
言える	いえる
あれっ	あれっ
キョロキョロ	キョロキョロ
フラフラ	フラフラ
じゃあね	じゃあね
no	data
行く手	ゆくて
悠長	ゆうちょう
飛び跳ねる	とびはねる
ちょこん	ちょこん
才	さい
先方	せんぽう
話は別	はなしはべつ
相談に乗る	そうだんにのる
定か	さだか
ぞろぞろ	ぞろぞろ
競技	きょうぎ
養子	ようし
製作	せいさく
ぶつかり合う	ぶつかりあう
大いなる	おおいなる
縮む	ちぢむ
淑女	しゅくじょ
ちらっと	ちらっと
筒	つつ
頭が痛い	あたまがいたい
分身	ぶんしん
生き残り	いきのこり
朦朧	もうろう
威圧	いあつ
許	もと
掲示板	けいじばん
垣間見る	かいまみる
エロ	エロ
直視	ちょくし
洗濯物	せんたくもの
食糧	しょくりょう
子供っぽい	こどもっぽい
様な	ような
校庭	こうてい
打ち砕く	うちくだく
迷子になる	まいごになる
外套	がいとう
朗らか	ほがらか
寄り道	よりみち
静止	せいし
入力	にゅうりょく
無茶苦茶	むちゃくちゃ
枕元	まくらもと
口出し	くちだし
エース	エース
オーナー	オーナー
球体	きゅうたい
クリーム	クリーム
巡回	じゅんかい
美術	びじゅつ
転送	てんそう
眉根を寄せる	まゆねをよせる
ダッシュ	ダッシュ
大喜び	おおよろこび
今宵	こよい
タコ	タコ
同期	どうき
裁く	さばく
賞賛	しょうさん
吹っ飛ばす	ふっとばす
緊急事態	きんきゅうじたい
小物	こもの
害する	がいする
輸送	ゆそう
湯船	ゆぶね
支配者	しはいしゃ
彫刻	ちょうこく
飛び乗る	とびのる
がっちり	がっちり
心中	しんじゅう
ハマる	ハマる
ごきげんよう	ごきげんよう
もたれかかる	もたれかかる
奇怪	きかい
引っ越し	ひっこし
おそろしい	おそろしい
ことば	ことば
ネコ	ネコ
とろける	とろける
ほぐす	ほぐす
かすれる	かすれる
あん	あん
くだす	くだす
あとにする	あとにする
窓ガラス	まどガラス
とたんに	とたんに
降りかかる	ふりかかる
口をきく	くちをきく
ヘン	ヘン
にこり	にこり
言いだす	いいだす
ちがいない	ちがいない
チラチラ	チラチラ
声かけ	こえかけ
ズレる	ズレる
アッ	アッ
おまけ	おまけ
じゃろ	じゃろ
席につく	せきにつく
ひょいと	ひょいと
物陰	ものかげ
泣き叫ぶ	なきさけぶ
結合	けつごう
白銀	はくぎん
走り抜ける	はしりぬける
善意	ぜんい
もやもや	もやもや
三年生	さんねんせい
火力	かりょく
点数	てんすう
幾度も	いくども
ネクタイ	ネクタイ
余程	よほど
手近	てぢか
苛む	さいなむ
仕組む	しくむ
送信	そうしん
地帯	ちたい
専属	せんぞく
ネックレス	ネックレス
腑に落ちる	ふにおちる
あんな風に	あんなふうに
縮こまる	ちぢこまる
模する	もする
機構	きこう
呼応	こおう
柳	やなぎ
バター	バター
返り討ち	かえりうち
脈打つ	みゃくうつ
靴下	くつした
no	data
送り届ける	おくりとどける
リング	リング
危害を加える	きがいをくわえる
迎え撃つ	むかえうつ
差し入れ	さしいれ
口内	こうない
死刑	しけい
荷	に
片目	かため
大柄	おおがら
楽勝	らくしょう
ぶら下がる	ぶらさがる
怒号	どごう
そうみたい	そうみたい
操縦	そうじゅう
爆発音	ばくはつおん
士気	しき
直々	じきじき
商業	しょうぎょう
補足	ほそく
怪我人	けがにん
弾き飛ばす	はじきとばす
赤黒い	あかぐろい
一段落	いちだんらく
陽	よう
漁る	あさる
侵す	おかす
連合	れんごう
廻る	まわる
思い直す	おもいなおす
資質	ししつ
昼飯	ひるめし
音色	ねいろ
家畜	かちく
八時	はちじ
顧問	こもん
ぶるぶる	ぶるぶる
ほほう	ほほう
お金持ち	おかねもち
軽口	かるくち
不審者	ふしんしゃ
ぽっかり	ぽっかり
途方に暮れる	とほうにくれる
十九	じゅうきゅう
チビ	チビ
馬鹿馬鹿しい	ばかばかしい
二人して	ふたりして
元凶	げんきょう
喪失	そうしつ
ハンバーグ	ハンバーグ
胸中	きょうちゅう
ほどく	ほどく
虹	にじ
精いっぱい	せいいっぱい
ヒト	ヒト
なぞ	なぞ
背もたれ	せもたれ
なにもかも	なにもかも
カエル	カエル
気がない	きがない
気がかり	きがかり
ちい	ちい
とかなんとか	とかなんとか
ワタシ	ワタシ
むき出し	むきだし
ほどほど	ほどほど
もらす	もらす
芝生	しばふ
常連	じょうれん
疲弊	ひへい
十時	じゅうじ
お祈り	おいのり
水滴	すいてき
ふむふむ	ふむふむ
戦況	せんきょう
オレンジ色	オレンジいろ
全い	まったい
埋め込む	うめこむ
容器	ようき
張	ちょう
いやでも	いやでも
大国	たいこく
禍々しい	まがまがしい
簡素	かんそ
腕時計	うでどけい
義母	ぎぼ
侵略	しんりゃく
だけでいい	だけでいい
一理	いちり
踏ん張る	ふんばる
突き破る	つきやぶる
真横	まよこ
さあて	さあて
無線	むせん
矢先	やさき
言葉を選ぶ	ことばをえらぶ
目を奪う	めをうばう
爆破	ばくは
行き着く	いきつく
黄	き
狙撃	そげき
no	data
身を寄せる	みをよせる
温か	あたたか
西洋	せいよう
情け	なさけ
賢者	けんじゃ
マッサージ	マッサージ
先刻	せんこく
助け出す	たすけだす
数多	あまた
昨年	さくねん
見返り	みかえり
逸れる	それる
幼女	ようじょ
露わ	あらわ
気が引ける	きがひける
黒幕	くろまく
慣れ	なれ
真逆	まぎゃく
可能な限り	かのうなかぎり
混む	こむ
上達	じょうたつ
婿	むこ
更なる	さらなる
六時	ろくじ
奇遇	きぐう
身柄	みがら
釘	くぎ
二十五	にじゅうご
山々	やまやま
プリン	プリン
無垢	むく
撒き散らす	まきちらす
やり遂げる	やりとげる
目に映る	めにうつる
押し返す	おしかえす
艦	かん
歪	いびつ
胸の内	むねのうち
奥底	おくそこ
乗っかる	のっかる
鮮血	せんけつ
大差	たいさ
長居	ながい
せめてもの	せめてもの
札	ふだ
ナンパ	ナンパ
フリ	フリ
もたれる	もたれる
こった	こった
ひとつひとつ	ひとつひとつ
よぶ	よぶ
なんとしても	なんとしても
建前	たてまえ
かなえる	かなえる
どきどき	どきどき
やっかい	やっかい
噛みつく	かみつく
スッと	スッと
馴染み	なじみ
ご用	ごよう
よけい	よけい
コト	コト
ふたりとも	ふたりとも
数ヶ月	すうかげつ
さみしい	さみしい
no	data
その為	そのため
編成	へんせい
絡まる	からまる
八月	はちがつ
染み	しみ
張本人	ちょうほんにん
奢る	おごる
仕込み	しこみ
圧	あつ
休み時間	やすみじかん
目を背ける	めをそむける
雄叫び	おたけび
思い込み	おもいこみ
息子さん	むすこさん
救い出す	すくいだす
作動	さどう
号令	ごうれい
因果	いんが
飛	ひ
射程	しゃてい
精鋭	せいえい
陥れる	おとしいれる
滅亡	めつぼう
雄	おす
愛液	あいえき
気分転換	きぶんてんかん
諸	しょ
手が届く	てがとどく
満喫	まんきつ
びっしり	びっしり
酷	こく
高み	たかみ
鋼鉄	こうてつ
達人	たつじん
ふれる	ふれる
引っ掛かる	ひっかかる
蒼白	そうはく
画	え
うねる	うねる
中枢	ちゅうすう
尚更	なおさら
賑わう	にぎわう
あたたかい	あたたかい
飼い主	かいぬし
二分	にぶん
被せる	かぶせる
心苦しい	こころぐるしい
ポスター	ポスター
はぐれる	はぐれる
トーン	トーン
議員	ぎいん
走り続ける	はしりつづける
互角	ごかく
従順	じゅうじゅん
１個	いっこ
煮る	にる
ジャージ	ジャージ
押しつぶす	おしつぶす
非常識	ひじょうしき
膣内	ちつない
強盗	ごうとう
霞む	かすむ
ハードル	ハードル
斜面	しゃめん
ウッ	ウッ
今日中に	きょうじゅうに
邪	よこしま
外壁	がいへき
抑え込む	おさえこむ
茶化す	ちゃかす
股	また
寝そべる	ねそべる
飛び出る	とびでる
小川	おがわ
二月	にがつ
身を任せる	みをまかせる
ぽつん	ぽつん
望むところ	のぞむところ
あむ	あむ
途方もない	とほうもない
ぶっきらぼう	ぶっきらぼう
殴りつける	なぐりつける
のばす	のばす
荒野	こうや
イタズラ	イタズラ
ではなさそう	ではなさそう
弱み	よわみ
ほん	ほん
首をひねる	くびをひねる
気をつけ	きをつけ
引きつける	ひきつける
くち	くち
だまる	だまる
ブツブツ	ブツブツ
またもや	またもや
ごちそう	ごちそう
まなざし	まなざし
はぐらかす	はぐらかす
